State,Year,OffAge_Count,OffAge_Mean,OffAge_Min,OffAge_Max,Incidents,N/A Age
Alabama,1976,431,34.65893271461717,11.0,84.0,504,73
Alabama,1977,437,34.50800915331808,13.0,85.0,504,67
Alabama,1978,460,35.03260869565217,13.0,77.0,493,33
Alabama,1979,450,33.87777777777778,13.0,85.0,487,37
Alabama,1980,461,33.939262472885034,13.0,90.0,513,52
Alabama,1981,397,35.241813602015114,11.0,86.0,453,56
Alabama,1982,386,34.73056994818653,9.0,90.0,424,38
Alabama,1983,329,33.01215805471124,11.0,82.0,372,43
Alabama,1984,339,34.87315634218289,13.0,83.0,382,43
Alabama,1985,346,33.6878612716763,12.0,84.0,397,51
Alabama,1986,370,34.1,13.0,83.0,407,37
Alabama,1987,296,33.96283783783784,10.0,73.0,336,40
Alabama,1988,348,32.775862068965516,14.0,83.0,389,41
Alabama,1989,354,31.271186440677965,10.0,87.0,416,62
Alabama,1990,410,31.7390243902439,14.0,91.0,463,53
Alabama,1991,222,30.815315315315317,13.0,84.0,434,212
Alabama,1992,219,32.10958904109589,10.0,82.0,391,172
Alabama,1993,289,31.972318339100347,14.0,93.0,477,188
Alabama,1994,293,30.09556313993174,15.0,92.0,501,208
Alabama,1995,252,30.373015873015873,12.0,79.0,467,215
Alabama,1996,244,30.10655737704918,12.0,78.0,430,186
Alabama,1997,244,30.983606557377048,15.0,75.0,415,171
Alabama,1998,202,31.985148514851485,10.0,78.0,343,141
Alabama,1999,10,41.5,22.0,79.0,15,5
Alabama,2000,165,32.03030303030303,13.0,78.0,235,70
Alabama,2001,210,30.733333333333334,13.0,79.0,347,137
Alabama,2002,188,31.664893617021278,15.0,86.0,292,104
Alabama,2003,166,31.987951807228917,12.0,79.0,295,129
Alabama,2004,172,32.43604651162791,15.0,79.0,253,81
Alabama,2005,224,31.397321428571427,15.0,80.0,327,103
Alabama,2006,246,30.158536585365855,13.0,76.0,358,112
Alabama,2007,267,30.662921348314608,14.0,66.0,392,125
Alabama,2008,245,30.693877551020407,14.0,76.0,342,97
Alabama,2009,219,31.625570776255707,16.0,87.0,318,99
Alabama,2010,136,35.72794117647059,14.0,84.0,191,55
Alabama,2011,154,32.616883116883116,11.0,76.0,339,185
Alabama,2012,146,32.23287671232877,14.0,89.0,333,187
Alabama,2013,203,32.881773399014776,14.0,82.0,367,164
Alabama,2014,175,32.90857142857143,14.0,91.0,349,174
Alabama,2015,206,32.02427184466019,10.0,82.0,445,239
Alabama,2016,265,30.41509433962264,10.0,99.0,493,228
Alabama,2017,311,30.19614147909968,1.0,99.0,575,264
Alabama,2018,270,29.585185185185185,1.0,73.0,502,232
Alabama,2019,3,26.666666666666668,20.0,36.0,4,1
Alabama,2020,19,33.31578947368421,15.0,51.0,24,5
Alabama,2021,253,30.031620553359684,1.0,99.0,381,128
Alaska,1976,37,32.810810810810814,7.0,68.0,47,10
Alaska,1977,32,30.6875,14.0,59.0,47,15
Alaska,1978,44,28.15909090909091,13.0,58.0,50,6
Alaska,1979,35,33.25714285714286,16.0,66.0,51,16
Alaska,1980,37,32.75675675675676,7.0,61.0,47,10
Alaska,1981,62,28.967741935483872,11.0,57.0,69,7
Alaska,1982,47,28.148936170212767,14.0,61.0,75,28
Alaska,1983,63,30.793650793650794,9.0,57.0,74,11
Alaska,1984,45,26.91111111111111,13.0,47.0,52,7
Alaska,1985,35,31.742857142857144,14.0,68.0,50,15
Alaska,1986,38,29.263157894736842,11.0,63.0,47,9
Alaska,1987,38,32.10526315789474,17.0,59.0,48,10
Alaska,1988,28,31.642857142857142,14.0,71.0,30,2
Alaska,1989,36,28.805555555555557,16.0,48.0,41,5
Alaska,1990,35,27.142857142857142,12.0,56.0,37,2
Alaska,1991,38,28.42105263157895,10.0,61.0,45,7
Alaska,1992,33,29.303030303030305,13.0,48.0,44,11
Alaska,1993,45,30.555555555555557,14.0,62.0,60,15
Alaska,1994,36,30.555555555555557,14.0,78.0,44,8
Alaska,1995,34,30.41176470588235,15.0,59.0,54,20
Alaska,1996,25,28.24,15.0,58.0,41,16
Alaska,1997,51,34.666666666666664,2.0,84.0,55,4
Alaska,1998,30,29.333333333333332,11.0,56.0,42,12
Alaska,1999,40,31.825,5.0,64.0,56,16
Alaska,2000,23,27.130434782608695,8.0,57.0,35,12
Alaska,2001,34,32.911764705882355,16.0,64.0,39,5
Alaska,2002,33,29.363636363636363,12.0,52.0,41,8
Alaska,2003,37,31.972972972972972,14.0,55.0,44,7
Alaska,2004,41,34.65853658536585,15.0,72.0,44,3
Alaska,2005,30,28.7,16.0,71.0,37,7
Alaska,2006,32,31.96875,14.0,67.0,42,10
Alaska,2007,49,28.408163265306122,12.0,63.0,53,4
Alaska,2008,27,31.074074074074073,15.0,53.0,33,6
Alaska,2009,32,31.65625,16.0,65.0,36,4
Alaska,2010,39,34.64102564102564,19.0,62.0,43,4
Alaska,2011,35,34.714285714285715,17.0,66.0,36,1
Alaska,2012,35,27.314285714285713,8.0,61.0,40,5
Alaska,2013,36,30.444444444444443,6.0,73.0,41,5
Alaska,2014,41,29.878048780487806,16.0,69.0,48,7
Alaska,2015,60,31.966666666666665,9.0,71.0,71,11
Alaska,2016,60,29.783333333333335,11.0,67.0,69,9
Alaska,2017,62,34.483870967741936,16.0,91.0,77,15
Alaska,2018,59,32.94915254237288,16.0,68.0,64,5
Alaska,2019,66,33.53030303030303,12.0,99.0,78,12
Alaska,2020,52,31.96153846153846,12.0,73.0,56,4
Alaska,2021,28,34.142857142857146,18.0,58.0,31,3
Arizona,1976,124,32.20161290322581,11.0,73.0,169,45
Arizona,1977,176,31.505681818181817,3.0,86.0,231,55
Arizona,1978,178,31.252808988764045,4.0,82.0,242,64
Arizona,1979,173,32.445086705202314,12.0,79.0,233,60
Arizona,1980,212,31.816037735849058,13.0,93.0,293,81
Arizona,1981,174,33.793103448275865,15.0,80.0,237,63
Arizona,1982,168,30.202380952380953,13.0,83.0,247,79
Arizona,1983,180,32.21111111111111,13.0,91.0,225,45
Arizona,1984,164,30.329268292682926,10.0,75.0,248,84
Arizona,1985,186,33.03225806451613,13.0,82.0,264,78
Arizona,1986,213,32.12206572769953,8.0,90.0,321,108
Arizona,1987,186,32.3494623655914,10.0,88.0,266,80
Arizona,1988,210,33.36190476190476,5.0,84.0,306,96
Arizona,1989,198,31.626262626262626,5.0,82.0,291,93
Arizona,1990,215,30.12558139534884,8.0,82.0,301,86
Arizona,1991,229,30.49344978165939,7.0,93.0,308,79
Arizona,1992,241,30.61410788381743,4.0,84.0,345,104
Arizona,1993,252,30.484126984126984,12.0,83.0,362,110
Arizona,1994,287,30.592334494773517,14.0,85.0,438,151
Arizona,1995,288,28.5,12.0,81.0,478,190
Arizona,1996,227,29.889867841409693,12.0,94.0,390,163
Arizona,1997,229,31.139737991266376,7.0,82.0,401,172
Arizona,1998,222,30.225225225225227,13.0,81.0,396,174
Arizona,1999,248,30.75,6.0,83.0,424,176
Arizona,2000,232,32.456896551724135,15.0,78.0,385,153
Arizona,2001,259,30.590733590733592,13.0,71.0,448,189
Arizona,2002,250,30.168,14.0,77.0,446,196
Arizona,2003,251,30.916334661354583,3.0,83.0,482,231
Arizona,2004,252,31.511904761904763,15.0,78.0,458,206
Arizona,2005,261,31.137931034482758,12.0,85.0,473,212
Arizona,2006,276,32.70289855072464,1.0,88.0,509,233
Arizona,2007,278,30.31294964028777,13.0,87.0,516,238
Arizona,2008,279,31.18637992831541,12.0,89.0,453,174
Arizona,2009,239,33.46443514644351,3.0,82.0,370,131
Arizona,2010,268,32.906716417910445,14.0,82.0,400,132
Arizona,2011,267,33.47565543071161,14.0,86.0,379,112
Arizona,2012,265,35.2,15.0,88.0,365,100
Arizona,2013,287,33.965156794425084,4.0,87.0,383,96
Arizona,2014,222,34.02252252252252,15.0,77.0,313,91
Arizona,2015,250,33.556,16.0,87.0,344,94
Arizona,2016,268,34.20522388059702,16.0,89.0,394,126
Arizona,2017,312,36.032051282051285,15.0,96.0,484,172
Arizona,2018,302,34.26158940397351,13.0,82.0,425,123
Arizona,2019,290,32.7,14.0,86.0,398,108
Arizona,2020,375,34.296,12.0,90.0,523,148
Arizona,2021,372,33.733870967741936,14.0,93.0,501,129
Arkansas,1976,168,33.99404761904762,10.0,84.0,180,12
Arkansas,1977,156,33.6025641025641,8.0,86.0,168,12
Arkansas,1978,179,31.497206703910614,6.0,85.0,198,19
Arkansas,1979,195,33.774358974358975,12.0,83.0,206,11
Arkansas,1980,184,34.18478260869565,13.0,77.0,214,30
Arkansas,1981,177,34.96610169491525,9.0,77.0,209,32
Arkansas,1982,176,36.46022727272727,12.0,92.0,195,19
Arkansas,1983,189,32.3068783068783,5.0,82.0,199,10
Arkansas,1984,172,33.18023255813954,13.0,80.0,183,11
Arkansas,1985,174,32.01149425287356,11.0,75.0,188,14
Arkansas,1986,177,33.36158192090395,14.0,89.0,202,25
Arkansas,1987,159,34.320754716981135,14.0,74.0,187,28
Arkansas,1988,183,33.53005464480874,9.0,79.0,216,33
Arkansas,1989,191,31.654450261780106,5.0,85.0,219,28
Arkansas,1990,223,31.2152466367713,8.0,93.0,254,31
Arkansas,1991,229,30.358078602620086,13.0,67.0,269,40
Arkansas,1992,228,29.486842105263158,12.0,77.0,255,27
Arkansas,1993,209,29.9377990430622,4.0,72.0,264,55
Arkansas,1994,244,30.385245901639344,14.0,86.0,303,59
Arkansas,1995,208,29.052884615384617,13.0,80.0,267,59
Arkansas,1996,175,30.074285714285715,13.0,87.0,219,44
Arkansas,1997,203,31.8128078817734,12.0,83.0,255,52
Arkansas,1998,168,31.958333333333332,11.0,78.0,209,41
Arkansas,1999,124,32.733870967741936,13.0,82.0,151,27
Arkansas,2000,143,30.937062937062937,13.0,91.0,163,20
Arkansas,2001,111,29.045045045045047,13.0,80.0,147,36
Arkansas,2002,107,33.0,15.0,88.0,146,39
Arkansas,2003,124,30.427419354838708,13.0,64.0,157,33
Arkansas,2004,112,32.267857142857146,7.0,69.0,157,45
Arkansas,2005,136,32.036764705882355,14.0,99.0,181,45
Arkansas,2006,149,30.677852348993287,15.0,64.0,205,56
Arkansas,2007,151,32.556291390728475,13.0,84.0,198,47
Arkansas,2008,136,32.25735294117647,16.0,75.0,165,29
Arkansas,2009,132,31.484848484848484,13.0,74.0,173,41
Arkansas,2010,108,33.43518518518518,14.0,81.0,141,33
Arkansas,2011,121,32.1900826446281,11.0,90.0,160,39
Arkansas,2012,138,31.043478260869566,12.0,65.0,176,38
Arkansas,2013,121,32.68595041322314,15.0,83.0,156,35
Arkansas,2014,134,33.992537313432834,17.0,78.0,169,35
Arkansas,2015,155,32.70967741935484,14.0,71.0,179,24
Arkansas,2016,176,32.23295454545455,11.0,75.0,218,42
Arkansas,2017,213,32.821596244131456,11.0,89.0,265,52
Arkansas,2018,188,32.159574468085104,14.0,78.0,241,53
Arkansas,2019,205,32.49268292682927,12.0,80.0,253,48
Arkansas,2020,255,33.04705882352941,13.0,99.0,340,85
Arkansas,2021,253,31.74308300395257,12.0,78.0,339,86
California,1976,1702,30.16921269095182,10.0,99.0,2372,670
California,1977,1649,30.082474226804123,6.0,90.0,2523,874
California,1978,1823,29.584750411409765,5.0,86.0,2747,924
California,1979,1970,30.012690355329948,13.0,93.0,3068,1098
California,1980,2219,29.574583145561064,6.0,99.0,3590,1371
California,1981,2228,30.070017953321365,3.0,88.0,2885,657
California,1982,2088,30.20402298850575,8.0,92.0,2976,888
California,1983,1938,30.59029927760578,12.0,96.0,2830,892
California,1984,1904,30.821953781512605,10.0,89.0,2888,984
California,1985,2043,30.83455702398434,12.0,88.0,2986,943
California,1986,2132,30.17776735459662,7.0,96.0,3260,1128
California,1987,2002,30.234265734265733,10.0,87.0,3166,1164
California,1988,2171,30.23721787194841,3.0,94.0,3135,964
California,1989,2412,29.04021558872305,7.0,90.0,3412,1000
California,1990,2547,28.219473890851983,5.0,91.0,3862,1315
California,1991,2531,28.16080600553141,6.0,91.0,4146,1615
California,1992,2467,28.188082691528173,10.0,86.0,4195,1728
California,1993,2628,28.26826484018265,10.0,87.0,4370,1742
California,1994,2468,27.448541329011345,9.0,95.0,3962,1494
California,1995,2185,27.648970251716246,10.0,90.0,3760,1575
California,1996,1822,28.478046103183313,11.0,95.0,3101,1279
California,1997,1529,29.14388489208633,9.0,89.0,2773,1244
California,1998,1437,28.673625608907447,9.0,90.0,2353,916
California,1999,1236,30.62864077669903,4.0,91.0,2132,896
California,2000,1333,30.108027006751687,4.0,89.0,2219,886
California,2001,1390,29.56115107913669,11.0,83.0,2357,967
California,2002,1509,29.351888667992046,14.0,86.0,2549,1040
California,2003,1424,30.299157303370787,12.0,94.0,2584,1160
California,2004,1502,29.927430093209054,13.0,86.0,2566,1064
California,2005,1568,29.225765306122447,10.0,87.0,2651,1083
California,2006,1537,29.41769681197137,11.0,87.0,2649,1112
California,2007,1286,30.412130637636082,13.0,93.0,2425,1139
California,2008,1270,30.519685039370078,12.0,94.0,2291,1021
California,2009,1251,31.276578737010393,12.0,90.0,2132,881
California,2010,1121,31.983050847457626,9.0,84.0,1948,827
California,2011,1147,32.46381865736704,10.0,96.0,1931,784
California,2012,1202,32.38352745424293,10.0,87.0,2047,845
California,2013,1083,32.87257617728532,13.0,91.0,1930,847
California,2014,1093,32.92680695333943,14.0,87.0,1872,779
California,2015,1185,33.44556962025317,12.0,93.0,2041,856
California,2016,1157,33.01642178046672,13.0,87.0,2087,930
California,2017,1116,34.7168458781362,13.0,97.0,1994,878
California,2018,1141,34.891323400525856,13.0,95.0,1879,738
California,2019,1085,34.97142857142857,12.0,89.0,1818,733
California,2020,1311,33.57360793287567,10.0,95.0,2379,1068
California,2021,97,31.608247422680414,1.0,71.0,2415,2318
Colorado,1976,126,31.80952380952381,11.0,75.0,183,57
Colorado,1977,131,31.641221374045802,12.0,82.0,176,45
Colorado,1978,148,31.81756756756757,15.0,65.0,194,46
Colorado,1979,123,29.065040650406505,5.0,71.0,171,48
Colorado,1980,128,30.390625,12.0,87.0,198,70
Colorado,1981,152,31.605263157894736,12.0,67.0,230,78
Colorado,1982,139,29.68345323741007,9.0,68.0,193,54
Colorado,1983,154,31.448051948051948,13.0,76.0,214,60
Colorado,1984,147,30.653061224489797,9.0,70.0,192,45
Colorado,1985,159,30.830188679245282,13.0,72.0,204,45
Colorado,1986,185,30.951351351351352,8.0,81.0,247,62
Colorado,1987,154,31.746753246753247,14.0,83.0,211,57
Colorado,1988,154,31.25974025974026,12.0,76.0,206,52
Colorado,1989,138,30.297101449275363,14.0,69.0,166,28
Colorado,1990,142,31.619718309859156,4.0,92.0,166,24
Colorado,1991,163,30.165644171779142,2.0,76.0,213,50
Colorado,1992,168,30.160714285714285,14.0,83.0,232,64
Colorado,1993,147,29.46938775510204,13.0,70.0,221,74
Colorado,1994,127,28.244094488188978,13.0,71.0,187,60
Colorado,1995,170,30.394117647058824,10.0,72.0,219,49
Colorado,1996,143,30.818181818181817,10.0,82.0,182,39
Colorado,1997,125,31.64,12.0,93.0,175,50
Colorado,1998,160,28.95,6.0,67.0,195,35
Colorado,1999,155,27.29032258064516,13.0,57.0,201,46
Colorado,2000,107,33.83177570093458,15.0,64.0,134,27
Colorado,2001,125,31.72,5.0,85.0,154,29
Colorado,2002,142,33.91549295774648,16.0,80.0,181,39
Colorado,2003,126,30.650793650793652,1.0,93.0,190,64
Colorado,2004,150,31.98,14.0,74.0,216,66
Colorado,2005,136,32.80882352941177,14.0,83.0,177,41
Colorado,2006,119,30.89075630252101,15.0,61.0,176,57
Colorado,2007,128,32.4453125,16.0,82.0,161,33
Colorado,2008,142,32.66197183098591,16.0,85.0,160,18
Colorado,2009,157,32.203821656050955,13.0,91.0,165,8
Colorado,2010,117,34.02564102564103,14.0,66.0,145,28
Colorado,2011,144,34.423611111111114,12.0,82.0,167,23
Colorado,2012,148,33.304054054054056,14.0,71.0,172,24
Colorado,2013,161,36.04347826086956,13.0,80.0,186,25
Colorado,2014,143,34.41258741258741,13.0,87.0,165,22
Colorado,2015,155,36.71612903225807,16.0,99.0,189,34
Colorado,2016,180,34.25555555555555,16.0,81.0,208,28
Colorado,2017,213,31.985915492957748,15.0,85.0,252,39
Colorado,2018,226,31.805309734513273,12.0,76.0,248,22
Colorado,2019,227,35.22466960352423,1.0,86.0,275,48
Colorado,2020,290,32.641379310344824,11.0,77.0,349,59
Colorado,2021,364,33.387362637362635,12.0,95.0,433,69
Connecticut,1976,74,29.37837837837838,6.0,73.0,88,14
Connecticut,1977,97,33.44329896907217,14.0,86.0,120,23
Connecticut,1978,95,29.50526315789474,12.0,85.0,122,27
Connecticut,1979,98,31.193877551020407,17.0,72.0,122,24
Connecticut,1980,113,31.707964601769913,15.0,75.0,158,45
Connecticut,1981,117,28.39316239316239,11.0,78.0,155,38
Connecticut,1982,125,30.656,16.0,73.0,164,39
Connecticut,1983,105,28.6,9.0,66.0,130,25
Connecticut,1984,89,31.39325842696629,13.0,74.0,116,27
Connecticut,1985,93,28.118279569892472,13.0,66.0,124,31
Connecticut,1986,99,30.757575757575758,14.0,69.0,148,49
Connecticut,1987,126,29.547619047619047,14.0,88.0,162,36
Connecticut,1988,125,29.096,15.0,60.0,181,56
Connecticut,1989,126,30.22222222222222,14.0,78.0,197,71
Connecticut,1990,95,29.621052631578948,14.0,85.0,177,82
Connecticut,1991,111,30.55855855855856,15.0,89.0,172,61
Connecticut,1992,105,28.104761904761904,12.0,88.0,181,76
Connecticut,1993,120,29.091666666666665,8.0,72.0,222,102
Connecticut,1994,120,26.608333333333334,14.0,83.0,220,100
Connecticut,1995,108,28.75925925925926,14.0,74.0,156,48
Connecticut,1996,101,28.495049504950494,16.0,67.0,166,65
Connecticut,1997,76,29.17105263157895,7.0,70.0,132,56
Connecticut,1998,93,28.408602150537636,14.0,60.0,144,51
Connecticut,1999,74,33.013513513513516,9.0,84.0,117,43
Connecticut,2000,74,29.972972972972972,16.0,94.0,100,26
Connecticut,2001,78,30.384615384615383,14.0,68.0,112,34
Connecticut,2002,57,30.087719298245613,13.0,87.0,86,29
Connecticut,2003,80,28.8125,13.0,89.0,110,30
Connecticut,2004,70,31.242857142857144,12.0,88.0,103,33
Connecticut,2005,80,30.35,17.0,64.0,111,31
Connecticut,2006,74,31.83783783783784,16.0,79.0,113,39
Connecticut,2007,60,38.56666666666667,16.0,81.0,109,49
Connecticut,2008,79,30.39240506329114,16.0,86.0,132,53
Connecticut,2009,62,29.161290322580644,15.0,55.0,106,44
Connecticut,2010,80,32.4625,16.0,77.0,134,54
Connecticut,2011,70,29.12857142857143,16.0,63.0,130,60
Connecticut,2012,96,28.364583333333332,17.0,63.0,145,49
Connecticut,2013,60,29.416666666666668,17.0,75.0,93,33
Connecticut,2014,67,28.80597014925373,16.0,59.0,90,23
Connecticut,2015,69,35.43478260869565,18.0,74.0,111,42
Connecticut,2016,47,33.191489361702125,16.0,70.0,79,32
Connecticut,2017,77,31.636363636363637,15.0,75.0,117,40
Connecticut,2018,57,35.78947368421053,12.0,90.0,93,36
Connecticut,2019,74,36.21621621621622,16.0,92.0,116,42
Connecticut,2020,100,33.59,16.0,80.0,161,61
Connecticut,2021,104,33.59615384615385,13.0,77.0,164,60
Delaware,1976,33,33.696969696969695,10.0,72.0,39,6
Delaware,1977,25,34.0,18.0,84.0,32,7
Delaware,1978,33,31.666666666666668,16.0,57.0,40,7
Delaware,1979,32,31.40625,14.0,59.0,34,2
Delaware,1980,32,30.40625,16.0,62.0,44,12
Delaware,1981,33,31.060606060606062,13.0,67.0,41,8
Delaware,1982,32,28.875,17.0,57.0,36,4
Delaware,1983,23,34.78260869565217,16.0,73.0,27,4
Delaware,1984,21,33.333333333333336,12.0,57.0,24,3
Delaware,1985,27,39.074074074074076,16.0,79.0,32,5
Delaware,1986,29,31.75862068965517,14.0,82.0,32,3
Delaware,1987,26,30.346153846153847,14.0,80.0,32,6
Delaware,1988,24,36.916666666666664,13.0,64.0,34,10
Delaware,1989,29,29.20689655172414,14.0,63.0,33,4
Delaware,1990,29,31.344827586206897,17.0,83.0,33,4
Delaware,1991,15,24.266666666666666,16.0,49.0,39,24
Delaware,1992,14,23.857142857142858,15.0,46.0,20,6
Delaware,1993,20,28.4,15.0,62.0,22,2
Delaware,1994,8,29.625,15.0,44.0,14,6
Delaware,1995,9,26.88888888888889,15.0,52.0,9,0
Delaware,1996,27,41.51851851851852,15.0,84.0,33,6
Delaware,1997,13,39.76923076923077,18.0,66.0,16,3
Delaware,1998,20,28.8,14.0,53.0,24,4
Delaware,1999,19,29.31578947368421,18.0,45.0,25,6
Delaware,2000,22,28.181818181818183,14.0,43.0,27,5
Delaware,2001,24,26.666666666666668,18.0,45.0,29,5
Delaware,2002,23,29.782608695652176,15.0,64.0,30,7
Delaware,2003,16,25.5,18.0,44.0,21,5
Delaware,2004,17,26.176470588235293,17.0,44.0,28,11
Delaware,2005,30,30.233333333333334,15.0,54.0,41,11
Delaware,2006,33,27.666666666666668,16.0,49.0,42,9
Delaware,2007,29,28.275862068965516,18.0,46.0,39,10
Delaware,2008,37,28.2972972972973,16.0,67.0,57,20
Delaware,2009,29,28.896551724137932,16.0,66.0,44,15
Delaware,2010,36,28.22222222222222,15.0,68.0,52,16
Delaware,2011,34,30.0,16.0,66.0,48,14
Delaware,2012,35,28.914285714285715,17.0,53.0,57,22
Delaware,2013,19,36.89473684210526,18.0,68.0,41,22
Delaware,2014,30,29.166666666666668,15.0,63.0,53,23
Delaware,2015,45,27.977777777777778,16.0,66.0,65,20
Delaware,2016,34,29.88235294117647,16.0,53.0,58,24
Delaware,2017,41,31.29268292682927,16.0,88.0,59,18
Delaware,2018,33,36.81818181818182,16.0,87.0,50,17
Delaware,2019,22,34.09090909090909,19.0,82.0,50,28
Delaware,2020,40,28.625,14.0,63.0,79,39
Delaware,2021,49,37.816326530612244,15.0,80.0,98,49
District of Columbia,1976,132,32.85606060606061,15.0,67.0,203,71
District of Columbia,1977,136,31.919117647058822,15.0,68.0,202,66
District of Columbia,1978,139,31.496402877697843,16.0,83.0,196,57
District of Columbia,1979,89,31.741573033707866,15.0,65.0,171,82
District of Columbia,1980,97,32.01030927835052,16.0,66.0,180,83
District of Columbia,1981,89,35.39325842696629,15.0,80.0,232,143
District of Columbia,1982,81,32.925925925925924,17.0,69.0,204,123
District of Columbia,1983,44,33.75,17.0,73.0,188,144
District of Columbia,1984,61,31.83606557377049,16.0,59.0,175,114
District of Columbia,1985,39,30.41025641025641,12.0,60.0,149,110
District of Columbia,1986,35,32.17142857142857,14.0,60.0,154,119
District of Columbia,1987,47,31.319148936170212,14.0,79.0,225,178
District of Columbia,1988,36,29.63888888888889,17.0,64.0,375,339
District of Columbia,1989,8,24.75,5.0,56.0,439,431
District of Columbia,1990,4,35.75,24.0,45.0,481,477
District of Columbia,1991,177,24.316384180790962,13.0,82.0,489,312
District of Columbia,1992,123,25.88617886178862,12.0,66.0,450,327
District of Columbia,1993,109,24.972477064220183,12.0,57.0,423,314
District of Columbia,1994,17,28.764705882352942,5.0,60.0,417,400
District of Columbia,1995,117,23.188034188034187,14.0,54.0,377,260
District of Columbia,1997,144,24.5,13.0,62.0,309,165
District of Columbia,2001,1,33.0,33.0,33.0,1,0
District of Columbia,2002,143,26.706293706293707,15.0,76.0,252,109
District of Columbia,2003,115,27.643478260869564,15.0,60.0,243,128
District of Columbia,2004,77,26.675324675324674,14.0,60.0,189,112
District of Columbia,2005,0,,,,187,187
District of Columbia,2006,14,29.0,14.0,51.0,165,151
District of Columbia,2007,4,21.75,18.0,28.0,174,170
District of Columbia,2009,59,31.54237288135593,15.0,80.0,157,98
District of Columbia,2010,70,26.15714285714286,16.0,59.0,134,64
District of Columbia,2011,52,28.173076923076923,15.0,58.0,116,64
District of Columbia,2013,56,29.678571428571427,17.0,46.0,115,59
District of Columbia,2014,46,30.0,17.0,59.0,114,68
District of Columbia,2015,73,28.931506849315067,17.0,70.0,172,99
District of Columbia,2016,60,29.25,15.0,67.0,150,90
District of Columbia,2017,57,30.49122807017544,14.0,67.0,125,68
District of Columbia,2018,74,30.06756756756757,15.0,70.0,161,87
District of Columbia,2019,71,29.661971830985916,15.0,61.0,178,107
District of Columbia,2020,108,28.37962962962963,14.0,64.0,219,111
District of Columbia,2021,115,31.617391304347827,12.0,66.0,259,144
Florida,1976,719,34.14186369958276,12.0,87.0,876,157
Florida,1977,679,33.985272459499264,10.0,89.0,880,201
Florida,1978,738,34.295392953929536,9.0,82.0,973,235
Florida,1979,798,33.714285714285715,4.0,85.0,1110,312
Florida,1980,981,32.51376146788991,11.0,83.0,1508,527
Florida,1981,998,33.342685370741485,8.0,95.0,1586,588
Florida,1982,975,33.70871794871795,6.0,88.0,1482,507
Florida,1983,859,33.445867287543656,7.0,96.0,1262,403
Florida,1984,876,32.37442922374429,5.0,80.0,1319,443
Florida,1985,868,33.78917050691244,4.0,84.0,1308,440
Florida,1986,978,32.63292433537832,6.0,83.0,1427,449
Florida,1987,924,32.416666666666664,9.0,85.0,1410,486
Florida,1991,1,27.0,27.0,27.0,1,0
Florida,1992,830,31.948192771084337,8.0,99.0,1257,427
Florida,1993,854,31.451990632318502,1.0,92.0,1329,475
Florida,1994,797,31.25219573400251,9.0,99.0,1278,481
Florida,1995,666,31.466966966966968,10.0,92.0,1114,448
Florida,1996,968,31.580578512396695,11.0,99.0,1425,457
Florida,1997,713,32.64656381486676,7.0,99.0,1067,354
Florida,1998,774,32.14341085271318,12.0,88.0,1085,311
Florida,1999,668,32.637724550898206,11.0,99.0,915,247
Florida,2000,514,32.71011673151751,11.0,99.0,814,300
Florida,2001,608,33.82072368421053,13.0,99.0,926,318
Florida,2002,628,33.01273885350319,11.0,99.0,959,331
Florida,2003,615,33.53170731707317,7.0,88.0,975,360
Florida,2004,656,33.21036585365854,6.0,99.0,1010,354
Florida,2005,630,32.17619047619048,6.0,99.0,959,329
Florida,2006,771,31.64721141374838,13.0,99.0,1209,438
Florida,2007,820,31.275609756097563,11.0,99.0,1348,528
Florida,2008,834,30.98441247002398,11.0,88.0,1294,460
Florida,2009,768,33.60546875,13.0,91.0,1161,393
Florida,2010,780,33.238461538461536,10.0,87.0,1129,349
Florida,2011,746,33.398123324396785,12.0,99.0,1135,389
Florida,2012,778,33.7133676092545,7.0,86.0,1169,391
Florida,2013,682,34.395894428152495,6.0,91.0,1127,445
Florida,2014,733,34.21009549795362,6.0,99.0,1155,422
Florida,2015,745,33.361073825503354,11.0,85.0,1195,450
Florida,2016,787,33.7992376111817,8.0,99.0,1259,472
Florida,2017,1232,21.694805194805195,0.0,90.0,1231,-1
Florida,2018,843,34.62040332147094,7.0,93.0,1277,434
Florida,2019,843,34.219454329774614,11.0,99.0,1288,445
Florida,2020,938,33.008528784648185,3.0,84.0,1481,543
Florida,2021,556,33.656474820143885,13.0,99.0,776,220
Georgia,1976,441,33.53061224489796,11.0,98.0,525,84
Georgia,1977,435,34.27816091954023,2.0,88.0,503,68
Georgia,1978,495,35.03636363636364,14.0,99.0,566,71
Georgia,1979,510,34.46470588235294,13.0,88.0,640,130
Georgia,1980,357,33.52100840336134,8.0,84.0,475,118
Georgia,1981,348,34.9367816091954,12.0,83.0,491,143
Georgia,1982,426,34.33802816901409,11.0,81.0,574,148
Georgia,1983,349,32.154727793696274,11.0,78.0,424,75
Georgia,1984,403,34.563275434243174,15.0,88.0,511,108
Georgia,1985,407,32.24078624078624,11.0,74.0,557,150
Georgia,1986,497,32.83702213279678,13.0,83.0,652,155
Georgia,1987,444,32.73198198198198,7.0,87.0,593,149
Georgia,1988,541,32.386321626617374,14.0,99.0,731,190
Georgia,1989,558,31.691756272401435,14.0,85.0,805,247
Georgia,1990,530,31.526415094339622,12.0,83.0,737,207
Georgia,1991,551,30.531760435571687,12.0,88.0,733,182
Georgia,1992,520,29.78076923076923,13.0,81.0,681,161
Georgia,1993,546,28.65934065934066,12.0,83.0,764,218
Georgia,1994,516,28.38372093023256,8.0,82.0,699,183
Georgia,1995,447,29.863534675615213,13.0,83.0,660,213
Georgia,1996,436,29.637614678899084,14.0,75.0,644,208
Georgia,1997,334,30.772455089820358,11.0,83.0,523,189
Georgia,1998,361,30.698060941828256,3.0,73.0,531,170
Georgia,1999,368,30.79891304347826,6.0,79.0,527,159
Georgia,2000,338,31.42603550295858,12.0,99.0,508,170
Georgia,2001,347,30.671469740634006,11.0,83.0,575,228
Georgia,2002,379,30.488126649076516,11.0,71.0,603,224
Georgia,2003,395,31.751898734177214,14.0,84.0,643,248
Georgia,2004,350,31.422857142857143,12.0,91.0,549,199
Georgia,2005,324,33.24074074074074,13.0,82.0,532,208
Georgia,2006,384,31.291666666666668,11.0,83.0,586,202
Georgia,2007,426,30.640845070422536,14.0,76.0,696,270
Georgia,2008,438,30.06392694063927,12.0,81.0,664,226
Georgia,2009,409,32.867970660146696,11.0,87.0,584,175
Georgia,2010,391,31.59846547314578,11.0,89.0,565,174
Georgia,2011,406,32.41379310344828,10.0,76.0,557,151
Georgia,2012,397,31.889168765743072,12.0,92.0,584,187
Georgia,2013,367,32.32697547683924,6.0,87.0,567,200
Georgia,2014,402,31.73134328358209,12.0,84.0,608,206
Georgia,2015,395,32.118987341772154,13.0,99.0,605,210
Georgia,2016,462,31.248917748917748,12.0,89.0,691,229
Georgia,2017,493,31.76267748478702,13.0,92.0,726,233
Georgia,2018,446,30.917040358744394,13.0,79.0,638,192
Georgia,2019,336,32.19047619047619,1.0,88.0,488,152
Georgia,2020,457,31.308533916849015,1.0,99.0,606,149
Georgia,2021,589,31.422750424448218,11.0,99.0,794,205
Hawaii,1976,39,28.128205128205128,16.0,56.0,58,19
Hawaii,1977,41,31.73170731707317,13.0,75.0,61,20
Hawaii,1978,36,30.0,7.0,76.0,59,23
Hawaii,1979,47,29.29787234042553,17.0,51.0,67,20
Hawaii,1980,59,33.96610169491525,18.0,78.0,84,25
Hawaii,1981,33,29.90909090909091,12.0,49.0,46,13
Hawaii,1982,21,31.19047619047619,19.0,65.0,33,12
Hawaii,1983,39,30.94871794871795,14.0,58.0,57,18
Hawaii,1984,25,33.08,15.0,75.0,34,9
Hawaii,1985,26,28.923076923076923,17.0,56.0,43,17
Hawaii,1986,29,33.310344827586206,19.0,62.0,52,23
Hawaii,1987,36,28.583333333333332,17.0,66.0,53,17
Hawaii,1988,37,31.594594594594593,14.0,69.0,47,10
Hawaii,1989,38,31.05263157894737,17.0,60.0,51,13
Hawaii,1990,32,33.875,15.0,78.0,45,13
Hawaii,1991,35,29.457142857142856,14.0,49.0,46,11
Hawaii,1992,39,33.1025641025641,15.0,72.0,43,4
Hawaii,1993,39,31.615384615384617,16.0,62.0,44,5
Hawaii,1994,46,32.67391304347826,16.0,64.0,53,7
Hawaii,1995,50,34.44,14.0,67.0,58,8
Hawaii,1996,34,34.26470588235294,14.0,80.0,41,7
Hawaii,1997,40,34.15,16.0,62.0,48,8
Hawaii,1998,24,33.291666666666664,16.0,55.0,27,3
Hawaii,1999,34,31.823529411764707,18.0,52.0,43,9
Hawaii,2000,30,36.333333333333336,16.0,80.0,35,5
Hawaii,2001,32,36.6875,14.0,68.0,36,4
Hawaii,2002,18,32.666666666666664,19.0,80.0,25,7
Hawaii,2003,17,34.88235294117647,22.0,88.0,23,6
Hawaii,2004,29,33.93103448275862,20.0,65.0,34,5
Hawaii,2005,18,28.666666666666668,16.0,50.0,25,7
Hawaii,2006,16,35.875,18.0,59.0,23,7
Hawaii,2007,24,35.916666666666664,15.0,83.0,26,2
Hawaii,2008,25,39.64,19.0,63.0,27,2
Hawaii,2009,23,36.17391304347826,20.0,70.0,24,1
Hawaii,2010,26,40.69230769230769,17.0,81.0,27,1
Hawaii,2011,22,29.772727272727273,17.0,50.0,24,2
Hawaii,2012,20,38.2,23.0,81.0,23,3
Hawaii,2013,20,33.05,21.0,57.0,24,4
Hawaii,2014,13,40.23076923076923,18.0,71.0,15,2
Hawaii,2015,27,34.370370370370374,18.0,63.0,31,4
Hawaii,2016,38,40.8421052631579,16.0,72.0,44,6
Hawaii,2017,32,37.75,16.0,75.0,42,10
Hawaii,2018,36,36.638888888888886,13.0,83.0,40,4
Hawaii,2019,26,33.96153846153846,19.0,74.0,33,7
Hawaii,2020,31,42.0,20.0,70.0,42,11
Hawaii,2021,5,37.6,23.0,48.0,8,3
Idaho,1976,45,28.511111111111113,16.0,57.0,48,3
Idaho,1977,44,32.04545454545455,12.0,71.0,51,7
Idaho,1978,42,37.285714285714285,14.0,77.0,46,4
Idaho,1979,44,32.77272727272727,13.0,59.0,56,12
Idaho,1980,24,31.25,18.0,66.0,30,6
Idaho,1981,41,28.951219512195124,17.0,76.0,45,4
Idaho,1982,18,33.333333333333336,17.0,76.0,25,7
Idaho,1983,32,31.59375,14.0,66.0,36,4
Idaho,1984,28,34.535714285714285,13.0,59.0,37,9
Idaho,1985,17,31.941176470588236,15.0,65.0,24,7
Idaho,1986,28,33.57142857142857,15.0,64.0,32,4
Idaho,1987,32,35.6875,18.0,77.0,35,3
Idaho,1988,27,33.370370370370374,18.0,63.0,35,8
Idaho,1989,21,29.238095238095237,14.0,71.0,28,7
Idaho,1990,29,31.517241379310345,12.0,77.0,34,5
Idaho,1991,14,33.642857142857146,16.0,66.0,17,3
Idaho,1992,36,32.388888888888886,17.0,65.0,38,2
Idaho,1993,31,33.193548387096776,16.0,65.0,32,1
Idaho,1994,38,31.605263157894736,12.0,55.0,40,2
Idaho,1995,43,31.162790697674417,15.0,77.0,48,5
Idaho,1996,47,33.765957446808514,15.0,73.0,50,3
Idaho,1997,36,34.083333333333336,16.0,70.0,43,7
Idaho,1998,33,32.84848484848485,15.0,87.0,36,3
Idaho,1999,25,26.36,17.0,48.0,26,1
Idaho,2000,14,37.57142857142857,16.0,77.0,17,3
Idaho,2001,31,33.58064516129032,16.0,80.0,33,2
Idaho,2002,35,31.885714285714286,14.0,70.0,36,1
Idaho,2003,25,30.72,16.0,63.0,28,3
Idaho,2004,29,33.241379310344826,20.0,58.0,32,3
Idaho,2005,41,33.926829268292686,17.0,82.0,42,1
Idaho,2006,33,34.03030303030303,16.0,69.0,33,0
Idaho,2007,49,32.204081632653065,16.0,65.0,51,2
Idaho,2008,19,42.421052631578945,17.0,85.0,23,4
Idaho,2009,21,32.19047619047619,14.0,90.0,22,1
Idaho,2010,21,41.76190476190476,19.0,91.0,22,1
Idaho,2011,31,33.58064516129032,19.0,85.0,31,0
Idaho,2012,28,34.035714285714285,12.0,71.0,29,1
Idaho,2013,29,37.172413793103445,20.0,62.0,30,1
Idaho,2014,27,30.59259259259259,14.0,56.0,30,3
Idaho,2015,30,31.233333333333334,17.0,86.0,32,2
Idaho,2016,46,34.28260869565217,18.0,62.0,47,1
Idaho,2017,45,39.37777777777778,17.0,83.0,48,3
Idaho,2018,36,36.166666666666664,16.0,71.0,37,1
Idaho,2019,40,37.45,17.0,80.0,40,0
Idaho,2020,47,42.59574468085106,18.0,90.0,49,2
Idaho,2021,46,38.95652173913044,19.0,72.0,46,0
Illinois,1976,941,29.197662061636557,12.0,81.0,1214,273
Illinois,1977,874,30.25858123569794,13.0,84.0,1173,299
Illinois,1978,910,29.520879120879123,10.0,81.0,1191,281
Illinois,1979,1000,29.531,6.0,83.0,1323,323
Illinois,1980,956,29.660041841004183,12.0,85.0,1323,367
Illinois,1981,904,29.29646017699115,4.0,88.0,1221,317
Illinois,1982,857,29.310385064177364,10.0,76.0,1108,251
Illinois,1983,848,30.30188679245283,5.0,85.0,1128,280
Illinois,1984,188,31.81382978723404,15.0,82.0,254,66
Illinois,1985,178,32.550561797752806,10.0,90.0,227,49
Illinois,1986,643,29.598755832037327,13.0,79.0,850,207
Illinois,1987,268,32.39179104477612,14.0,85.0,343,75
Illinois,1988,737,29.934871099050202,9.0,90.0,1000,263
Illinois,1989,819,28.406593406593405,10.0,82.0,1086,267
Illinois,1990,574,28.89547038327526,8.0,84.0,773,199
Illinois,1991,907,27.50606394707828,11.0,81.0,1289,382
Illinois,1992,831,27.607701564380264,12.0,81.0,1262,431
Illinois,1993,669,25.91479820627803,10.0,92.0,1014,345
Illinois,1994,780,25.615384615384617,10.0,73.0,1223,443
Illinois,1995,529,25.0,12.0,77.0,821,292
Illinois,1996,495,25.656565656565657,12.0,67.0,827,332
Illinois,1997,469,26.074626865671643,11.0,84.0,799,330
Illinois,1998,427,25.295081967213115,7.0,80.0,766,339
Illinois,1999,364,26.505494505494507,13.0,76.0,688,324
Illinois,2000,294,27.639455782312925,10.0,79.0,668,374
Illinois,2001,372,26.196236559139784,13.0,74.0,705,333
Illinois,2002,354,26.031073446327685,13.0,77.0,687,333
Illinois,2003,325,28.323076923076922,13.0,85.0,644,319
Illinois,2004,276,27.536231884057973,15.0,68.0,485,209
Illinois,2005,244,27.91393442622951,12.0,78.0,484,240
Illinois,2006,246,28.40650406504065,14.0,74.0,526,280
Illinois,2007,247,30.246963562753038,7.0,85.0,510,263
Illinois,2008,249,29.044176706827308,14.0,99.0,570,321
Illinois,2009,189,29.634920634920636,9.0,78.0,517,328
Illinois,2010,176,29.897727272727273,15.0,84.0,484,308
Illinois,2011,201,30.34825870646766,14.0,75.0,510,309
Illinois,2012,182,29.307692307692307,13.0,77.0,554,372
Illinois,2013,186,28.489247311827956,12.0,67.0,483,297
Illinois,2014,180,29.833333333333332,13.0,84.0,479,299
Illinois,2015,179,29.0,15.0,62.0,538,359
Illinois,2016,345,30.72463768115942,13.0,94.0,1013,668
Illinois,2017,302,31.02317880794702,11.0,75.0,852,550
Illinois,2018,359,32.62395543175487,15.0,80.0,884,525
Illinois,2019,297,32.515151515151516,9.0,89.0,802,505
Illinois,2020,395,31.222784810126583,14.0,85.0,1072,677
Illinois,2021,400,30.7475,14.0,98.0,1011,611
Indiana,1976,233,31.527896995708154,12.0,78.0,309,76
Indiana,1977,230,31.27391304347826,9.0,81.0,320,90
Indiana,1978,216,33.782407407407405,14.0,81.0,294,78
Indiana,1979,284,31.077464788732396,13.0,74.0,427,143
Indiana,1980,273,31.483516483516482,13.0,86.0,409,136
Indiana,1981,255,32.55686274509804,10.0,91.0,357,102
Indiana,1982,244,30.5327868852459,13.0,81.0,336,92
Indiana,1983,193,30.471502590673577,13.0,76.0,269,76
Indiana,1984,200,30.85,11.0,75.0,281,81
Indiana,1985,177,33.45762711864407,12.0,85.0,287,110
Indiana,1986,183,31.907103825136613,15.0,80.0,268,85
Indiana,1987,169,32.69822485207101,15.0,80.0,222,53
Indiana,1988,194,29.871134020618555,14.0,81.0,315,121
Indiana,1989,183,30.2896174863388,13.0,79.0,271,88
Indiana,1990,186,30.586021505376344,11.0,92.0,264,78
Indiana,1991,173,29.36994219653179,12.0,81.0,311,138
Indiana,1992,199,30.758793969849247,14.0,81.0,369,170
Indiana,1993,196,30.78061224489796,13.0,87.0,368,172
Indiana,1994,223,27.515695067264573,13.0,85.0,395,172
Indiana,1995,204,29.25980392156863,9.0,74.0,380,176
Indiana,1996,202,30.346534653465348,12.0,67.0,311,109
Indiana,1997,193,27.7720207253886,15.0,87.0,394,201
Indiana,1998,232,31.594827586206897,4.0,82.0,408,176
Indiana,1999,195,28.48205128205128,15.0,77.0,335,140
Indiana,2000,162,30.271604938271604,10.0,70.0,308,146
Indiana,2001,202,30.975247524752476,8.0,86.0,381,179
Indiana,2002,184,31.875,11.0,70.0,335,151
Indiana,2003,185,30.2972972972973,7.0,74.0,330,145
Indiana,2004,181,32.1767955801105,15.0,79.0,308,127
Indiana,2005,215,29.6,16.0,64.0,347,132
Indiana,2006,217,30.806451612903224,12.0,80.0,352,135
Indiana,2007,216,31.060185185185187,13.0,90.0,346,130
Indiana,2008,193,29.238341968911918,5.0,76.0,320,127
Indiana,2009,192,30.630208333333332,14.0,99.0,306,114
Indiana,2010,192,30.458333333333332,16.0,66.0,291,99
Indiana,2011,199,33.185929648241206,15.0,75.0,307,108
Indiana,2012,207,32.73913043478261,3.0,76.0,307,100
Indiana,2013,200,31.375,16.0,76.0,350,150
Indiana,2014,233,30.918454935622318,15.0,77.0,337,104
Indiana,2015,184,30.483695652173914,2.0,77.0,291,107
Indiana,2016,201,30.567164179104477,13.0,69.0,375,174
Indiana,2017,240,30.175,3.0,82.0,408,168
Indiana,2018,231,31.61038961038961,13.0,81.0,405,174
Indiana,2019,207,32.81642512077295,14.0,75.0,350,143
Indiana,2020,333,30.62762762762763,13.0,79.0,546,213
Indiana,2021,309,30.038834951456312,13.0,85.0,495,186
Iowa,1976,51,28.274509803921568,16.0,58.0,60,9
Iowa,1977,41,31.073170731707318,14.0,61.0,50,9
Iowa,1978,50,29.8,17.0,60.0,73,23
Iowa,1979,44,34.06818181818182,17.0,70.0,60,16
Iowa,1980,50,31.44,16.0,60.0,63,13
Iowa,1981,67,29.970149253731343,14.0,59.0,79,12
Iowa,1982,57,29.035087719298247,10.0,77.0,65,8
Iowa,1983,57,31.57894736842105,15.0,73.0,70,13
Iowa,1984,43,30.697674418604652,14.0,76.0,56,13
Iowa,1985,49,32.857142857142854,7.0,79.0,57,8
Iowa,1986,40,30.875,12.0,69.0,52,12
Iowa,1987,27,32.333333333333336,17.0,71.0,31,4
Iowa,1988,42,32.23809523809524,12.0,77.0,48,6
Iowa,1989,49,30.755102040816325,15.0,73.0,57,8
Iowa,1990,47,33.42553191489362,16.0,70.0,52,5
Iowa,1992,22,27.90909090909091,13.0,45.0,24,2
Iowa,1993,33,32.21212121212121,14.0,84.0,35,2
Iowa,1994,41,26.878048780487806,13.0,63.0,48,7
Iowa,1995,47,29.93617021276596,16.0,56.0,56,9
Iowa,1996,49,33.53061224489796,15.0,76.0,58,9
Iowa,1997,34,30.794117647058822,17.0,52.0,43,9
Iowa,1998,43,32.16279069767442,16.0,71.0,49,6
Iowa,1999,40,32.525,15.0,79.0,52,12
Iowa,2000,48,33.0625,18.0,76.0,52,4
Iowa,2001,45,31.622222222222224,16.0,98.0,53,8
Iowa,2002,45,30.0,16.0,58.0,49,4
Iowa,2003,47,32.851063829787236,18.0,73.0,51,4
Iowa,2004,39,29.17948717948718,16.0,64.0,47,8
Iowa,2005,37,34.5945945945946,14.0,52.0,42,5
Iowa,2006,50,31.86,14.0,74.0,54,4
Iowa,2007,37,32.21621621621622,15.0,72.0,43,6
Iowa,2008,70,33.25714285714286,16.0,53.0,79,9
Iowa,2009,43,32.604651162790695,14.0,66.0,44,1
Iowa,2010,36,32.02777777777778,12.0,70.0,39,3
Iowa,2011,45,35.15555555555556,18.0,73.0,47,2
Iowa,2012,42,28.5,16.0,63.0,51,9
Iowa,2013,39,31.23076923076923,16.0,82.0,42,3
Iowa,2014,57,36.78947368421053,17.0,74.0,63,6
Iowa,2015,70,32.25714285714286,14.0,62.0,79,9
Iowa,2016,65,34.06153846153846,15.0,79.0,79,14
Iowa,2017,89,32.01123595505618,14.0,63.0,112,23
Iowa,2018,37,37.0,18.0,69.0,45,8
Iowa,2019,59,32.644067796610166,15.0,70.0,64,5
Iowa,2020,99,32.717171717171716,15.0,81.0,124,25
Iowa,2021,89,33.550561797752806,15.0,86.0,95,6
Kansas,1976,74,29.027027027027028,11.0,62.0,98,24
Kansas,1977,105,30.923809523809524,11.0,69.0,141,36
Kansas,1978,100,32.29,14.0,82.0,127,27
Kansas,1979,111,30.83783783783784,14.0,70.0,133,22
Kansas,1980,142,30.661971830985916,16.0,72.0,163,21
Kansas,1981,136,31.176470588235293,9.0,68.0,165,29
Kansas,1982,113,32.13274336283186,15.0,77.0,144,31
Kansas,1983,114,32.43859649122807,16.0,65.0,146,32
Kansas,1984,68,28.88235294117647,13.0,99.0,96,28
Kansas,1985,107,29.121495327102803,13.0,77.0,128,21
Kansas,1986,79,31.455696202531644,11.0,83.0,103,24
Kansas,1987,73,30.698630136986303,15.0,62.0,106,33
Kansas,1988,30,33.36666666666667,16.0,69.0,38,8
Kansas,1989,64,29.859375,13.0,78.0,81,17
Kansas,1990,60,31.55,12.0,62.0,98,38
Kansas,1991,103,29.766990291262136,13.0,81.0,156,53
Kansas,1992,100,31.85,13.0,87.0,162,62
Kansas,1993,18,28.38888888888889,16.0,59.0,30,12
Kansas,2000,42,26.404761904761905,8.0,58.0,49,7
Kansas,2001,65,29.676923076923078,12.0,74.0,80,15
Kansas,2002,60,27.616666666666667,16.0,54.0,75,15
Kansas,2003,84,29.857142857142858,17.0,78.0,93,9
Kansas,2004,69,34.3768115942029,16.0,78.0,75,6
Kansas,2005,79,28.10126582278481,10.0,80.0,100,21
Kansas,2006,90,31.666666666666668,15.0,85.0,129,39
Kansas,2007,84,29.297619047619047,17.0,89.0,106,22
Kansas,2008,94,29.585106382978722,13.0,87.0,112,18
Kansas,2009,98,31.857142857142858,15.0,70.0,127,29
Kansas,2010,86,33.651162790697676,14.0,77.0,107,21
Kansas,2011,96,32.677083333333336,14.0,82.0,117,21
Kansas,2012,76,33.3421052631579,16.0,79.0,90,14
Kansas,2013,96,30.864583333333332,14.0,67.0,118,22
Kansas,2014,74,31.45945945945946,14.0,73.0,93,19
Kansas,2015,103,32.45631067961165,17.0,72.0,127,24
Kansas,2016,88,33.32954545454545,16.0,63.0,103,15
Kansas,2017,121,32.429752066115704,13.0,81.0,138,17
Kansas,2018,110,30.89090909090909,14.0,65.0,124,14
Kansas,2019,95,35.07368421052632,11.0,99.0,107,12
Kansas,2020,77,29.5974025974026,15.0,62.0,95,18
Kansas,2021,85,28.070588235294117,12.0,61.0,95,10
Kentucky,1976,326,34.37116564417178,14.0,86.0,377,51
Kentucky,1977,309,33.20711974110032,4.0,81.0,361,52
Kentucky,1978,298,34.73489932885906,12.0,83.0,327,29
Kentucky,1979,301,34.2358803986711,13.0,82.0,341,40
Kentucky,1980,325,33.50153846153846,15.0,74.0,389,64
Kentucky,1981,227,35.74449339207048,13.0,76.0,266,39
Kentucky,1982,233,35.94420600858369,12.0,81.0,286,53
Kentucky,1983,207,33.79710144927536,15.0,79.0,269,62
Kentucky,1984,202,34.851485148514854,14.0,75.0,243,41
Kentucky,1985,215,34.77209302325581,13.0,82.0,261,46
Kentucky,1986,211,32.41232227488152,12.0,78.0,251,40
Kentucky,1987,83,33.53012048192771,7.0,76.0,93,10
Kentucky,1989,101,37.17821782178218,14.0,77.0,167,66
Kentucky,1990,170,32.38823529411765,14.0,73.0,248,78
Kentucky,1991,193,33.58549222797927,14.0,99.0,250,57
Kentucky,1992,153,34.745098039215684,13.0,82.0,218,65
Kentucky,1993,211,33.90995260663507,15.0,66.0,240,29
Kentucky,1994,69,27.956521739130434,14.0,62.0,86,17
Kentucky,1995,173,30.526011560693643,13.0,86.0,260,87
Kentucky,1996,159,33.100628930817614,13.0,86.0,224,65
Kentucky,1997,167,32.191616766467064,13.0,83.0,221,54
Kentucky,1998,84,32.654761904761905,14.0,76.0,124,40
Kentucky,1999,48,30.104166666666668,9.0,74.0,84,36
Kentucky,2000,45,33.666666666666664,16.0,71.0,73,28
Kentucky,2001,50,30.72,17.0,87.0,81,31
Kentucky,2002,65,29.76923076923077,16.0,54.0,87,22
Kentucky,2003,53,28.09433962264151,12.0,68.0,82,29
Kentucky,2004,148,31.972972972972972,12.0,80.0,219,71
Kentucky,2005,124,34.54032258064516,15.0,69.0,180,56
Kentucky,2006,119,33.7563025210084,12.0,68.0,159,40
Kentucky,2007,161,35.298136645962735,14.0,69.0,209,48
Kentucky,2008,144,34.09027777777778,15.0,85.0,202,58
Kentucky,2009,146,33.10958904109589,14.0,89.0,190,44
Kentucky,2010,137,38.2992700729927,15.0,92.0,189,52
Kentucky,2011,115,37.21739130434783,15.0,78.0,161,46
Kentucky,2012,167,37.041916167664674,16.0,82.0,211,44
Kentucky,2013,130,36.93076923076923,16.0,84.0,174,44
Kentucky,2014,136,35.4485294117647,16.0,87.0,168,32
Kentucky,2015,169,32.857988165680474,14.0,73.0,238,69
Kentucky,2016,211,33.33649289099526,13.0,81.0,279,68
Kentucky,2017,237,34.063291139240505,14.0,75.0,307,70
Kentucky,2018,203,34.27093596059113,14.0,72.0,265,62
Kentucky,2019,176,33.13636363636363,13.0,84.0,247,71
Kentucky,2020,232,34.241379310344826,13.0,78.0,366,134
Kentucky,2021,261,33.28352490421456,10.0,81.0,426,165
Louisiana,1976,416,32.28365384615385,9.0,81.0,512,96
Louisiana,1977,487,32.24229979466119,4.0,83.0,594,107
Louisiana,1978,493,32.1764705882353,9.0,84.0,645,152
Louisiana,1979,542,31.038745387453876,10.0,82.0,724,182
Louisiana,1980,389,30.876606683804628,12.0,90.0,549,160
Louisiana,1981,495,30.917171717171716,9.0,81.0,650,155
Louisiana,1982,487,31.48665297741273,11.0,80.0,670,183
Louisiana,1983,397,31.120906801007557,14.0,78.0,580,183
Louisiana,1984,350,33.01714285714286,4.0,84.0,521,171
Louisiana,1985,312,31.974358974358974,13.0,74.0,453,141
Louisiana,1986,388,30.677835051546392,13.0,79.0,529,141
Louisiana,1987,268,31.794776119402986,14.0,79.0,382,114
Louisiana,1988,276,29.568840579710145,14.0,82.0,452,176
Louisiana,1989,367,29.52316076294278,10.0,85.0,586,219
Louisiana,1990,391,29.74936061381074,11.0,87.0,611,220
Louisiana,1991,266,29.51127819548872,7.0,78.0,332,66
Louisiana,1992,430,27.167441860465118,11.0,76.0,690,260
Louisiana,1993,413,28.048426150121067,7.0,78.0,800,387
Louisiana,1994,505,28.19009900990099,12.0,85.0,865,360
Louisiana,1995,399,27.902255639097746,9.0,71.0,750,351
Louisiana,1996,378,27.761904761904763,13.0,71.0,737,359
Louisiana,1997,410,29.7390243902439,10.0,85.0,675,265
Louisiana,1998,305,29.927868852459017,14.0,79.0,567,262
Louisiana,1999,278,30.946043165467625,14.0,89.0,482,204
Louisiana,2000,303,30.194719471947195,10.0,86.0,558,255
Louisiana,2001,269,30.550185873605948,11.0,77.0,511,242
Louisiana,2002,285,31.45964912280702,12.0,78.0,577,292
Louisiana,2003,297,30.232323232323232,13.0,99.0,601,304
Louisiana,2004,291,30.096219931271477,12.0,99.0,586,295
Louisiana,2005,260,30.023076923076925,14.0,85.0,433,173
Louisiana,2006,324,28.47222222222222,14.0,85.0,516,192
Louisiana,2007,381,29.186351706036746,12.0,82.0,607,226
Louisiana,2008,254,28.64566929133858,12.0,82.0,419,165
Louisiana,2009,306,29.045751633986928,13.0,83.0,520,214
Louisiana,2010,299,29.923076923076923,13.0,88.0,493,194
Louisiana,2011,274,30.532846715328468,14.0,81.0,509,235
Louisiana,2012,272,28.83823529411765,8.0,89.0,511,239
Louisiana,2013,279,30.096774193548388,8.0,86.0,478,199
Louisiana,2014,282,30.22340425531915,14.0,75.0,452,170
Louisiana,2015,316,31.84493670886076,12.0,98.0,522,206
Louisiana,2016,337,30.026706231454007,15.0,73.0,578,241
Louisiana,2017,383,31.39164490861619,8.0,75.0,612,229
Louisiana,2018,373,30.083109919571047,6.0,79.0,578,205
Louisiana,2019,375,30.461333333333332,11.0,76.0,575,200
Louisiana,2020,435,30.25287356321839,11.0,77.0,736,301
Louisiana,2021,405,29.479012345679013,12.0,99.0,823,418
Maine,1976,19,30.36842105263158,16.0,79.0,26,7
Maine,1977,22,28.5,14.0,54.0,29,7
Maine,1978,31,31.64516129032258,16.0,60.0,34,3
Maine,1979,29,34.310344827586206,14.0,72.0,33,4
Maine,1980,31,26.06451612903226,16.0,66.0,36,5
Maine,1981,29,34.37931034482759,15.0,61.0,36,7
Maine,1982,21,30.238095238095237,14.0,55.0,25,4
Maine,1983,23,30.608695652173914,13.0,52.0,29,6
Maine,1984,18,30.666666666666668,14.0,63.0,21,3
Maine,1985,22,33.54545454545455,17.0,82.0,29,7
Maine,1986,20,31.05,13.0,58.0,24,4
Maine,1987,28,33.07142857142857,13.0,57.0,33,5
Maine,1988,30,30.566666666666666,11.0,61.0,36,6
Maine,1989,45,30.22222222222222,6.0,61.0,46,1
Maine,1990,16,31.4375,19.0,50.0,18,2
Maine,1993,6,37.5,21.0,50.0,7,1
Maine,1994,24,36.041666666666664,14.0,76.0,32,8
Maine,1995,22,35.81818181818182,18.0,49.0,26,4
Maine,1996,25,31.88,14.0,53.0,26,1
Maine,1997,18,27.5,16.0,67.0,22,4
Maine,1998,27,32.03703703703704,15.0,46.0,27,0
Maine,1999,25,36.44,16.0,81.0,26,1
Maine,2000,14,36.57142857142857,17.0,61.0,15,1
Maine,2001,16,35.9375,19.0,68.0,21,5
Maine,2002,14,35.07142857142857,19.0,75.0,16,2
Maine,2003,14,36.357142857142854,20.0,53.0,16,2
Maine,2004,18,35.888888888888886,18.0,57.0,18,0
Maine,2005,19,38.526315789473685,14.0,86.0,20,1
Maine,2006,22,35.22727272727273,14.0,51.0,26,4
Maine,2007,23,31.217391304347824,18.0,59.0,26,3
Maine,2008,30,32.86666666666667,19.0,63.0,35,5
Maine,2009,24,35.125,17.0,55.0,27,3
Maine,2010,25,33.2,18.0,52.0,27,2
Maine,2011,32,36.8125,19.0,85.0,35,3
Maine,2012,31,38.54838709677419,10.0,74.0,33,2
Maine,2013,30,37.2,20.0,81.0,30,0
Maine,2014,28,33.857142857142854,18.0,66.0,29,1
Maine,2015,27,34.44444444444444,16.0,71.0,28,1
Maine,2016,21,36.523809523809526,17.0,80.0,23,2
Maine,2017,29,42.310344827586206,16.0,82.0,33,4
Maine,2018,24,38.666666666666664,15.0,76.0,27,3
Maine,2019,25,38.16,21.0,82.0,26,1
Maine,2020,27,40.111111111111114,19.0,71.0,29,2
Maine,2021,30,36.833333333333336,13.0,88.0,30,0
Maryland,1976,287,30.494773519163765,3.0,79.0,366,79
Maryland,1977,255,30.36470588235294,10.0,85.0,352,97
Maryland,1978,248,32.01209677419355,10.0,85.0,337,89
Maryland,1979,287,31.766550522648085,14.0,77.0,420,133
Maryland,1980,303,30.564356435643564,11.0,80.0,432,129
Maryland,1981,314,28.82484076433121,13.0,72.0,452,138
Maryland,1982,315,30.123809523809523,13.0,74.0,452,137
Maryland,1983,249,30.164658634538153,13.0,74.0,386,137
Maryland,1984,271,30.084870848708487,8.0,84.0,375,104
Maryland,1985,224,29.03125,3.0,72.0,360,136
Maryland,1986,262,30.16412213740458,3.0,85.0,406,144
Maryland,1987,255,29.44313725490196,7.0,83.0,372,117
Maryland,1988,290,28.43793103448276,9.0,83.0,459,169
Maryland,1989,359,28.94707520891365,12.0,70.0,558,199
Maryland,1990,376,28.03191489361702,14.0,80.0,578,202
Maryland,1991,359,28.89693593314763,13.0,75.0,585,226
Maryland,1992,354,27.570621468926554,13.0,64.0,623,269
Maryland,1993,377,27.180371352785144,11.0,86.0,662,285
Maryland,1994,328,28.41768292682927,10.0,88.0,616,288
Maryland,1995,387,26.583979328165373,12.0,82.0,622,235
Maryland,1996,331,27.27190332326284,12.0,87.0,598,267
Maryland,1997,261,28.264367816091955,11.0,73.0,522,261
Maryland,1998,278,28.507194244604317,9.0,83.0,528,250
Maryland,1999,212,28.08490566037736,13.0,74.0,442,230
Maryland,2000,255,29.95294117647059,14.0,91.0,462,207
Maryland,2001,254,27.24015748031496,6.0,78.0,485,231
Maryland,2002,243,29.477366255144034,13.0,74.0,546,303
Maryland,2003,246,29.048780487804876,4.0,79.0,542,296
Maryland,2004,237,29.054852320675106,12.0,81.0,539,302
Maryland,2005,225,28.324444444444445,13.0,77.0,576,351
Maryland,2006,264,28.24621212121212,11.0,80.0,571,307
Maryland,2007,236,29.889830508474578,14.0,79.0,581,345
Maryland,2008,244,29.62295081967213,13.0,90.0,536,292
Maryland,2009,237,30.713080168776372,14.0,87.0,469,232
Maryland,2010,218,30.339449541284402,13.0,82.0,445,227
Maryland,2011,212,32.09905660377358,14.0,85.0,429,217
Maryland,2012,205,30.33170731707317,12.0,92.0,403,198
Maryland,2013,199,30.90954773869347,14.0,64.0,406,207
Maryland,2014,166,33.602409638554214,11.0,84.0,337,171
Maryland,2015,185,31.54054054054054,13.0,87.0,495,310
Maryland,2016,187,32.01069518716577,11.0,77.0,495,308
Maryland,2017,234,31.871794871794872,13.0,93.0,559,325
Maryland,2018,207,32.671497584541065,14.0,99.0,495,288
Maryland,2019,205,32.93658536585366,11.0,84.0,575,370
Maryland,2020,206,31.95631067961165,13.0,80.0,513,307
Maryland,2021,191,31.42931937172775,14.0,76.0,488,297
Massachusetts,1976,121,31.00826446280992,13.0,71.0,178,57
Massachusetts,1977,115,31.956521739130434,15.0,75.0,164,49
Massachusetts,1978,158,31.17721518987342,15.0,81.0,211,53
Massachusetts,1979,146,29.561643835616437,9.0,75.0,211,65
Massachusetts,1980,140,29.321428571428573,15.0,87.0,223,83
Massachusetts,1981,152,30.085526315789473,13.0,60.0,203,51
Massachusetts,1982,137,30.124087591240876,14.0,64.0,217,80
Massachusetts,1983,141,29.05673758865248,12.0,63.0,197,56
Massachusetts,1984,123,32.96747967479675,14.0,86.0,196,73
Massachusetts,1985,138,29.78985507246377,15.0,83.0,188,50
Massachusetts,1986,97,31.0,14.0,68.0,163,66
Massachusetts,1987,98,26.959183673469386,12.0,76.0,145,47
Massachusetts,1988,116,27.198275862068964,15.0,67.0,154,38
Massachusetts,1989,102,30.362745098039216,14.0,71.0,172,70
Massachusetts,1990,100,28.92,13.0,79.0,186,86
Massachusetts,1991,110,28.436363636363637,11.0,57.0,214,104
Massachusetts,1992,120,28.583333333333332,14.0,85.0,180,60
Massachusetts,1993,126,28.88888888888889,14.0,60.0,210,84
Massachusetts,1994,120,28.05,13.0,73.0,205,85
Massachusetts,1995,130,31.646153846153847,14.0,80.0,213,83
Massachusetts,1996,95,27.621052631578948,15.0,69.0,161,66
Massachusetts,1997,91,29.934065934065934,14.0,79.0,126,35
Massachusetts,1998,88,27.693181818181817,15.0,76.0,123,35
Massachusetts,1999,90,31.18888888888889,10.0,87.0,119,29
Massachusetts,2000,89,29.741573033707866,15.0,68.0,119,30
Massachusetts,2001,90,27.711111111111112,11.0,53.0,151,61
Massachusetts,2002,116,29.517241379310345,16.0,68.0,171,55
Massachusetts,2003,91,31.0989010989011,16.0,82.0,143,52
Massachusetts,2004,98,29.908163265306122,12.0,78.0,172,74
Massachusetts,2005,93,28.849462365591396,15.0,72.0,178,85
Massachusetts,2006,110,29.436363636363637,14.0,69.0,188,78
Massachusetts,2007,111,29.963963963963963,16.0,65.0,187,76
Massachusetts,2008,87,29.942528735632184,16.0,74.0,166,79
Massachusetts,2009,106,30.754716981132077,16.0,86.0,173,67
Massachusetts,2010,136,31.227941176470587,13.0,75.0,219,83
Massachusetts,2011,105,31.37142857142857,17.0,72.0,184,79
Massachusetts,2012,63,30.238095238095237,14.0,79.0,122,59
Massachusetts,2013,82,32.71951219512195,14.0,70.0,136,54
Massachusetts,2014,67,34.298507462686565,11.0,65.0,132,65
Massachusetts,2015,77,31.92207792207792,14.0,78.0,131,54
Massachusetts,2016,79,31.050632911392405,15.0,88.0,133,54
Massachusetts,2017,116,32.93103448275862,15.0,99.0,178,62
Massachusetts,2018,75,35.61333333333334,18.0,78.0,140,65
Massachusetts,2019,107,33.42056074766355,15.0,83.0,156,49
Massachusetts,2020,104,31.307692307692307,17.0,78.0,167,63
Massachusetts,2021,110,35.17272727272727,16.0,86.0,152,42
Michigan,1976,758,30.670184696569923,11.0,84.0,1074,316
Michigan,1977,665,30.48872180451128,9.0,82.0,928,263
Michigan,1978,659,31.1608497723824,4.0,79.0,886,227
Michigan,1979,640,30.5890625,8.0,78.0,857,217
Michigan,1980,696,31.42241379310345,6.0,76.0,973,277
Michigan,1981,640,31.0390625,9.0,82.0,906,266
Michigan,1982,581,32.68674698795181,13.0,82.0,889,308
Michigan,1983,521,32.170825335892516,11.0,81.0,902,381
Michigan,1984,547,31.012797074954296,11.0,82.0,899,352
Michigan,1985,655,30.874809160305343,8.0,99.0,1066,411
Michigan,1986,680,31.53529411764706,9.0,95.0,1067,387
Michigan,1987,770,28.88831168831169,11.0,78.0,1153,383
Michigan,1988,726,30.66253443526171,4.0,86.0,1037,311
Michigan,1989,703,28.965860597439544,12.0,83.0,1016,313
Michigan,1990,680,28.955882352941178,13.0,87.0,997,317
Michigan,1991,711,28.40646976090014,13.0,93.0,1028,317
Michigan,1992,636,29.371069182389938,12.0,79.0,985,349
Michigan,1993,618,27.78802588996764,13.0,84.0,976,358
Michigan,1994,589,27.70458404074703,11.0,88.0,946,357
Michigan,1995,519,28.705202312138727,9.0,89.0,834,315
Michigan,1996,428,30.035046728971963,7.0,88.0,720,292
Michigan,1997,375,30.650666666666666,13.0,83.0,746,371
Michigan,1998,407,30.029484029484028,8.0,84.0,727,320
Michigan,1999,381,30.015748031496063,13.0,72.0,737,356
Michigan,2000,390,29.494871794871795,6.0,76.0,694,304
Michigan,2001,360,29.666666666666668,13.0,99.0,674,314
Michigan,2002,368,31.206521739130434,10.0,77.0,694,326
Michigan,2003,314,32.27070063694268,13.0,80.0,636,322
Michigan,2004,316,32.89556962025316,15.0,81.0,663,347
Michigan,2005,344,32.325581395348834,1.0,99.0,650,306
Michigan,2006,391,32.11764705882353,10.0,99.0,734,343
Michigan,2007,370,31.521621621621623,1.0,76.0,674,304
Michigan,2008,284,31.366197183098592,12.0,91.0,564,280
Michigan,2009,354,33.06497175141243,12.0,85.0,646,292
Michigan,2010,332,30.822289156626507,13.0,66.0,606,274
Michigan,2011,358,31.893854748603353,13.0,88.0,668,310
Michigan,2012,387,31.914728682170544,13.0,99.0,731,344
Michigan,2013,380,32.747368421052634,12.0,91.0,645,265
Michigan,2014,398,32.13316582914573,12.0,83.0,576,178
Michigan,2015,347,33.73487031700288,11.0,99.0,611,264
Michigan,2016,336,33.479166666666664,1.0,78.0,631,295
Michigan,2017,459,32.88453159041394,14.0,99.0,640,181
Michigan,2018,426,33.852112676056336,1.0,78.0,620,194
Michigan,2019,440,32.82727272727273,9.0,99.0,620,180
Michigan,2020,557,32.49551166965889,1.0,87.0,848,291
Michigan,2021,588,31.45578231292517,1.0,83.0,868,280
Minnesota,1976,82,28.23170731707317,11.0,74.0,109,27
Minnesota,1977,80,31.0125,17.0,67.0,100,20
Minnesota,1978,59,31.64406779661017,3.0,66.0,77,18
Minnesota,1979,79,31.379746835443036,14.0,83.0,104,25
Minnesota,1980,92,31.92391304347826,10.0,72.0,112,20
Minnesota,1981,70,32.67142857142857,17.0,73.0,87,17
Minnesota,1982,88,32.90909090909091,14.0,85.0,99,11
Minnesota,1983,53,35.0188679245283,14.0,59.0,68,15
Minnesota,1984,62,32.04838709677419,17.0,73.0,76,14
Minnesota,1985,70,32.385714285714286,13.0,68.0,90,20
Minnesota,1986,76,28.855263157894736,14.0,85.0,101,25
Minnesota,1987,84,31.44047619047619,14.0,73.0,109,25
Minnesota,1988,99,29.545454545454547,12.0,80.0,121,22
Minnesota,1989,89,30.865168539325843,12.0,71.0,108,19
Minnesota,1990,51,34.09803921568628,15.0,82.0,65,14
Minnesota,1991,94,28.46808510638298,14.0,73.0,116,22
Minnesota,1992,111,28.414414414414413,6.0,84.0,136,25
Minnesota,1993,112,28.5,12.0,72.0,140,28
Minnesota,1994,110,28.60909090909091,13.0,63.0,144,34
Minnesota,1995,129,28.2015503875969,13.0,73.0,180,51
Minnesota,1996,122,31.25409836065574,15.0,72.0,162,40
Minnesota,1997,99,27.525252525252526,15.0,85.0,127,28
Minnesota,1998,95,28.957894736842107,13.0,75.0,117,22
Minnesota,1999,104,30.807692307692307,13.0,91.0,131,27
Minnesota,2000,82,31.21951219512195,17.0,66.0,113,31
Minnesota,2001,97,30.855670103092784,14.0,57.0,120,23
Minnesota,2002,99,28.91919191919192,13.0,60.0,116,17
Minnesota,2003,111,28.045045045045047,13.0,69.0,126,15
Minnesota,2004,97,28.50515463917526,15.0,80.0,121,24
Minnesota,2005,97,30.412371134020617,15.0,73.0,120,23
Minnesota,2006,95,28.4,13.0,65.0,124,29
Minnesota,2007,95,28.86315789473684,10.0,85.0,111,16
Minnesota,2008,95,31.842105263157894,15.0,76.0,118,23
Minnesota,2009,75,31.226666666666667,17.0,70.0,89,14
Minnesota,2010,83,31.698795180722893,14.0,66.0,105,22
Minnesota,2011,65,34.33846153846154,16.0,81.0,82,17
Minnesota,2012,90,31.68888888888889,4.0,89.0,116,26
Minnesota,2013,97,31.876288659793815,15.0,75.0,127,30
Minnesota,2014,84,32.92857142857143,15.0,87.0,110,26
Minnesota,2015,111,33.891891891891895,14.0,90.0,146,35
Minnesota,2016,93,33.086021505376344,17.0,75.0,122,29
Minnesota,2017,101,33.277227722772274,14.0,66.0,129,28
Minnesota,2018,110,33.45454545454545,12.0,95.0,127,17
Minnesota,2019,107,32.63551401869159,15.0,77.0,144,37
Minnesota,2020,172,31.930232558139537,14.0,79.0,230,58
Minnesota,2021,202,32.56435643564357,9.0,84.0,274,72
Mississippi,1976,171,35.74269005847953,11.0,84.0,187,16
Mississippi,1977,197,33.984771573604064,13.0,72.0,219,22
Mississippi,1978,189,33.0,12.0,86.0,209,20
Mississippi,1979,183,32.349726775956285,16.0,79.0,207,24
Mississippi,1980,192,33.572916666666664,14.0,82.0,218,26
Mississippi,1981,216,34.041666666666664,13.0,99.0,246,30
Mississippi,1982,207,35.48792270531401,15.0,87.0,232,25
Mississippi,1983,183,34.387978142076506,15.0,76.0,198,15
Mississippi,1984,153,32.69281045751634,15.0,84.0,165,12
Mississippi,1985,161,31.67080745341615,14.0,70.0,180,19
Mississippi,1986,153,31.58169934640523,11.0,89.0,170,17
Mississippi,1987,160,32.73125,12.0,79.0,178,18
Mississippi,1988,132,32.96212121212121,11.0,90.0,152,20
Mississippi,1989,146,31.554794520547944,15.0,75.0,169,23
Mississippi,1990,161,31.15527950310559,15.0,91.0,178,17
Mississippi,1991,193,29.44559585492228,13.0,81.0,219,26
Mississippi,1992,184,28.559782608695652,12.0,67.0,209,25
Mississippi,1993,196,29.68877551020408,6.0,82.0,234,38
Mississippi,1994,196,27.571428571428573,12.0,66.0,232,36
Mississippi,1995,143,28.433566433566433,9.0,78.0,201,58
Mississippi,1996,157,29.59235668789809,14.0,81.0,190,33
Mississippi,1997,152,27.789473684210527,10.0,58.0,193,41
Mississippi,1998,146,30.102739726027398,15.0,85.0,185,39
Mississippi,1999,119,30.016806722689076,14.0,73.0,151,32
Mississippi,2000,141,30.69503546099291,15.0,69.0,174,33
Mississippi,2001,131,30.557251908396946,14.0,65.0,193,62
Mississippi,2002,141,30.22695035460993,4.0,75.0,194,53
Mississippi,2003,158,31.082278481012658,10.0,80.0,191,33
Mississippi,2004,140,31.25,13.0,77.0,181,41
Mississippi,2005,145,33.213793103448275,15.0,81.0,164,19
Mississippi,2006,134,29.5,15.0,70.0,180,46
Mississippi,2007,124,30.64516129032258,16.0,79.0,154,30
Mississippi,2008,143,30.867132867132867,15.0,83.0,192,49
Mississippi,2009,131,32.64885496183206,15.0,77.0,162,31
Mississippi,2010,138,32.34057971014493,16.0,74.0,174,36
Mississippi,2011,143,31.657342657342657,14.0,70.0,195,52
Mississippi,2012,130,31.453846153846154,15.0,62.0,179,49
Mississippi,2013,107,28.261682242990656,14.0,68.0,147,40
Mississippi,2014,125,30.176,15.0,71.0,173,48
Mississippi,2015,125,31.8,16.0,75.0,160,35
Mississippi,2016,113,31.876106194690266,15.0,75.0,157,44
Mississippi,2017,128,30.8828125,15.0,70.0,162,34
Mississippi,2018,103,31.349514563106798,15.0,70.0,157,54
Mississippi,2019,149,30.550335570469798,16.0,74.0,204,55
Mississippi,2020,148,30.533783783783782,14.0,99.0,237,89
Mississippi,2021,141,31.5531914893617,3.0,84.0,173,32
Missouri,1976,277,30.613718411552348,11.0,77.0,421,144
Missouri,1977,321,29.925233644859812,8.0,78.0,459,138
Missouri,1978,286,31.22027972027972,13.0,82.0,458,172
Missouri,1979,292,31.95205479452055,13.0,83.0,504,212
Missouri,1980,314,29.328025477707005,12.0,81.0,531,217
Missouri,1981,275,30.94909090909091,9.0,78.0,511,236
Missouri,1982,245,31.60816326530612,10.0,70.0,465,220
Missouri,1983,235,30.314893617021276,14.0,94.0,388,153
Missouri,1984,182,30.725274725274726,2.0,82.0,344,162
Missouri,1985,221,31.687782805429865,3.0,81.0,387,166
Missouri,1986,287,32.390243902439025,11.0,92.0,447,160
Missouri,1987,225,32.95111111111111,13.0,88.0,395,170
Missouri,1988,253,31.81422924901186,11.0,93.0,394,141
Missouri,1989,256,29.19921875,4.0,80.0,413,157
Missouri,1990,264,31.015151515151516,13.0,86.0,438,174
Missouri,1991,253,28.375494071146246,11.0,85.0,523,270
Missouri,1992,261,29.478927203065133,12.0,78.0,519,258
Missouri,1993,374,27.09893048128342,12.0,77.0,560,186
Missouri,1994,374,27.459893048128343,13.0,75.0,554,180
Missouri,1995,334,29.149700598802394,12.0,79.0,455,121
Missouri,1996,276,29.8768115942029,4.0,83.0,407,131
Missouri,1997,272,29.327205882352942,13.0,80.0,402,130
Missouri,1998,258,29.624031007751938,10.0,92.0,387,129
Missouri,1999,228,31.50438596491228,8.0,89.0,341,113
Missouri,2000,221,29.95475113122172,8.0,83.0,343,122
Missouri,2001,242,30.731404958677686,13.0,89.0,396,154
Missouri,2002,252,32.42857142857143,11.0,88.0,352,100
Missouri,2003,235,31.52340425531915,6.0,88.0,323,88
Missouri,2004,262,31.801526717557252,13.0,82.0,377,115
Missouri,2005,266,30.473684210526315,8.0,72.0,425,159
Missouri,2006,227,31.691629955947135,13.0,76.0,356,129
Missouri,2007,237,32.19831223628692,8.0,74.0,401,164
Missouri,2008,283,33.36749116607774,9.0,86.0,493,210
Missouri,2009,241,31.070539419087137,13.0,88.0,422,181
Missouri,2010,294,30.88095238095238,11.0,84.0,450,156
Missouri,2011,289,32.32871972318339,13.0,66.0,402,113
Missouri,2012,301,31.38205980066445,12.0,72.0,423,122
Missouri,2013,261,33.38697318007663,14.0,93.0,405,144
Missouri,2014,250,33.376,14.0,88.0,439,189
Missouri,2015,320,32.775,11.0,84.0,538,218
Missouri,2016,351,32.72649572649573,13.0,83.0,579,228
Missouri,2017,392,32.109693877551024,13.0,83.0,659,267
Missouri,2018,394,33.15736040609137,5.0,88.0,609,215
Missouri,2019,385,32.30649350649351,14.0,87.0,628,243
Missouri,2020,396,31.6010101010101,14.0,78.0,619,223
Missouri,2021,416,32.14182692307692,6.0,88.0,639,223
Montana,1976,19,30.68421052631579,18.0,58.0,27,8
Montana,1977,24,28.458333333333332,14.0,56.0,30,6
Montana,1978,32,32.46875,14.0,53.0,36,4
Montana,1979,30,30.266666666666666,13.0,58.0,33,3
Montana,1980,24,29.458333333333332,15.0,70.0,29,5
Montana,1981,22,34.95454545454545,19.0,66.0,23,1
Montana,1982,1,20.0,20.0,20.0,1,0
Montana,1983,20,37.15,16.0,57.0,23,3
Montana,1984,29,33.0,14.0,73.0,32,3
Montana,1985,27,34.370370370370374,5.0,79.0,30,3
Montana,1986,1,19.0,19.0,19.0,2,1
Montana,1988,17,30.529411764705884,16.0,54.0,19,2
Montana,1989,21,34.76190476190476,20.0,55.0,22,1
Montana,1990,1,48.0,48.0,48.0,1,0
Montana,1991,17,37.705882352941174,21.0,68.0,18,1
Montana,1992,19,32.63157894736842,18.0,61.0,20,1
Montana,1995,19,29.210526315789473,15.0,49.0,19,0
Montana,1997,12,31.166666666666668,16.0,61.0,16,4
Montana,1998,10,30.2,14.0,42.0,11,1
Montana,1999,11,27.272727272727273,16.0,45.0,11,0
Montana,2000,11,26.272727272727273,17.0,61.0,12,1
Montana,2001,22,31.727272727272727,17.0,60.0,22,0
Montana,2002,11,25.727272727272727,14.0,41.0,13,2
Montana,2003,21,33.23809523809524,14.0,74.0,22,1
Montana,2004,26,28.923076923076923,17.0,63.0,29,3
Montana,2005,21,29.523809523809526,18.0,51.0,23,2
Montana,2006,17,36.88235294117647,18.0,85.0,21,4
Montana,2007,14,33.07142857142857,18.0,57.0,15,1
Montana,2008,26,32.11538461538461,17.0,62.0,28,2
Montana,2009,27,40.48148148148148,11.0,85.0,28,1
Montana,2010,23,39.17391304347826,18.0,81.0,23,0
Montana,2011,15,41.4,19.0,81.0,19,4
Montana,2012,22,40.27272727272727,16.0,75.0,23,1
Montana,2013,16,33.25,19.0,67.0,16,0
Montana,2014,29,38.89655172413793,21.0,72.0,30,1
Montana,2015,32,41.8125,17.0,79.0,38,6
Montana,2016,36,36.55555555555556,19.0,59.0,37,1
Montana,2017,39,37.43589743589744,18.0,75.0,43,4
Montana,2018,38,30.026315789473685,16.0,72.0,40,2
Montana,2019,34,37.088235294117645,18.0,77.0,37,3
Montana,2020,61,35.377049180327866,14.0,62.0,69,8
Montana,2021,38,33.55263157894737,18.0,61.0,39,1
Nebraska,1976,39,29.974358974358974,12.0,54.0,44,5
Nebraska,1977,49,28.53061224489796,15.0,64.0,51,2
Nebraska,1978,34,29.970588235294116,9.0,67.0,36,2
Nebraska,1979,48,30.25,15.0,64.0,64,16
Nebraska,1980,54,30.462962962962962,12.0,81.0,58,4
Nebraska,1981,48,28.583333333333332,14.0,66.0,57,9
Nebraska,1982,33,30.21212121212121,16.0,75.0,35,2
Nebraska,1983,40,34.5,18.0,71.0,44,4
Nebraska,1984,47,30.829787234042552,13.0,78.0,54,7
Nebraska,1985,43,35.97674418604651,16.0,89.0,46,3
Nebraska,1986,53,30.132075471698112,14.0,59.0,55,2
Nebraska,1987,23,36.21739130434783,14.0,54.0,25,2
Nebraska,1988,54,29.22222222222222,13.0,63.0,58,4
Nebraska,1989,36,27.72222222222222,14.0,55.0,40,4
Nebraska,1990,35,33.74285714285714,16.0,73.0,42,7
Nebraska,1991,51,32.15686274509804,15.0,74.0,56,5
Nebraska,1992,38,34.68421052631579,17.0,85.0,44,6
Nebraska,1993,30,31.4,13.0,62.0,31,1
Nebraska,1994,15,36.06666666666667,15.0,59.0,19,4
Nebraska,1995,17,31.0,16.0,55.0,21,4
Nebraska,1996,19,27.894736842105264,13.0,69.0,21,2
Nebraska,1997,17,27.705882352941178,17.0,46.0,22,5
Nebraska,1998,24,35.375,16.0,76.0,25,1
Nebraska,1999,21,30.714285714285715,18.0,44.0,26,5
Nebraska,2000,25,34.88,17.0,62.0,29,4
Nebraska,2001,16,31.8125,19.0,53.0,19,3
Nebraska,2002,21,30.476190476190474,14.0,66.0,23,2
Nebraska,2003,16,32.1875,18.0,65.0,21,5
Nebraska,2004,22,27.363636363636363,15.0,70.0,30,8
Nebraska,2005,14,30.928571428571427,19.0,55.0,15,1
Nebraska,2006,15,30.866666666666667,18.0,65.0,17,2
Nebraska,2007,23,34.56521739130435,19.0,58.0,23,0
Nebraska,2008,21,33.523809523809526,17.0,57.0,23,2
Nebraska,2009,30,33.9,17.0,83.0,47,17
Nebraska,2010,34,29.08823529411765,14.0,52.0,58,24
Nebraska,2011,51,32.450980392156865,15.0,73.0,71,20
Nebraska,2012,27,29.925925925925927,16.0,53.0,56,29
Nebraska,2013,46,29.717391304347824,17.0,58.0,64,18
Nebraska,2014,46,31.391304347826086,9.0,76.0,57,11
Nebraska,2015,42,31.047619047619047,15.0,60.0,63,21
Nebraska,2016,33,39.0,15.0,86.0,43,10
Nebraska,2017,30,36.166666666666664,17.0,68.0,47,17
Nebraska,2018,31,33.03225806451613,14.0,72.0,45,14
Nebraska,2019,38,32.36842105263158,16.0,61.0,52,14
Nebraska,2020,55,28.745454545454546,9.0,59.0,67,12
Nebraska,2021,43,31.46511627906977,16.0,80.0,47,4
Nevada,1976,55,31.69090909090909,14.0,63.0,78,23
Nevada,1977,61,33.19672131147541,15.0,99.0,83,22
Nevada,1978,66,32.333333333333336,13.0,99.0,93,27
Nevada,1979,72,31.76388888888889,14.0,65.0,125,53
Nevada,1980,98,32.673469387755105,13.0,70.0,154,56
Nevada,1981,110,32.61818181818182,16.0,70.0,159,49
Nevada,1982,89,33.47191011235955,14.0,75.0,130,41
Nevada,1983,82,33.90243902439025,13.0,75.0,118,36
Nevada,1984,71,35.08450704225352,15.0,80.0,97,26
Nevada,1985,77,33.02597402597402,15.0,70.0,101,24
Nevada,1986,67,32.0,14.0,66.0,110,43
Nevada,1987,60,33.96666666666667,13.0,73.0,82,22
Nevada,1988,78,33.03846153846154,15.0,87.0,104,26
Nevada,1989,79,33.29113924050633,13.0,76.0,98,19
Nevada,1990,69,32.82608695652174,15.0,78.0,105,36
Nevada,1991,77,32.36363636363637,14.0,74.0,139,62
Nevada,1992,97,31.09278350515464,17.0,72.0,136,39
Nevada,1993,100,30.34,13.0,89.0,137,37
Nevada,1994,112,30.714285714285715,14.0,74.0,176,64
Nevada,1995,119,31.126050420168067,13.0,64.0,174,55
Nevada,1996,125,29.92,14.0,72.0,227,102
Nevada,1997,110,32.345454545454544,14.0,75.0,196,86
Nevada,1998,115,29.94782608695652,13.0,67.0,184,69
Nevada,1999,117,34.05128205128205,15.0,92.0,174,57
Nevada,2000,79,31.620253164556964,15.0,82.0,135,56
Nevada,2001,118,33.47457627118644,14.0,85.0,197,79
Nevada,2002,103,31.74757281553398,10.0,71.0,191,88
Nevada,2003,102,34.205882352941174,15.0,81.0,202,100
Nevada,2004,107,32.77570093457944,14.0,80.0,187,80
Nevada,2005,149,31.74496644295302,14.0,85.0,225,76
Nevada,2006,156,35.282051282051285,15.0,84.0,242,86
Nevada,2007,126,31.817460317460316,15.0,78.0,208,82
Nevada,2008,128,33.59375,7.0,87.0,183,55
Nevada,2009,148,33.83108108108108,15.0,86.0,183,35
Nevada,2010,131,32.94656488549618,14.0,79.0,175,44
Nevada,2011,124,33.266129032258064,11.0,66.0,155,31
Nevada,2012,105,35.20952380952381,14.0,86.0,136,31
Nevada,2013,137,34.01459854014598,12.0,81.0,168,31
Nevada,2014,131,34.94656488549618,15.0,84.0,185,54
Nevada,2015,134,35.69402985074627,15.0,84.0,203,69
Nevada,2016,159,32.9685534591195,15.0,79.0,228,69
Nevada,2017,232,42.12931034482759,17.0,84.0,311,79
Nevada,2018,186,33.20967741935484,14.0,82.0,239,53
Nevada,2019,129,33.1937984496124,10.0,78.0,179,50
Nevada,2020,164,37.40853658536585,14.0,83.0,206,42
Nevada,2021,213,32.88732394366197,14.0,78.0,243,30
New Hampshire,1976,16,24.3125,15.0,46.0,18,2
New Hampshire,1977,22,38.04545454545455,17.0,77.0,26,4
New Hampshire,1978,11,33.72727272727273,16.0,48.0,12,1
New Hampshire,1979,17,28.41176470588235,18.0,67.0,21,4
New Hampshire,1980,19,27.36842105263158,15.0,53.0,24,5
New Hampshire,1981,22,32.81818181818182,15.0,54.0,28,6
New Hampshire,1982,17,31.647058823529413,22.0,50.0,21,4
New Hampshire,1983,15,28.733333333333334,16.0,41.0,19,4
New Hampshire,1984,8,29.5,24.0,35.0,12,4
New Hampshire,1985,11,36.54545454545455,18.0,53.0,18,7
New Hampshire,1986,18,40.94444444444444,16.0,79.0,24,6
New Hampshire,1987,26,29.346153846153847,14.0,84.0,34,8
New Hampshire,1988,22,30.454545454545453,11.0,64.0,29,7
New Hampshire,1989,27,33.81481481481482,17.0,76.0,36,9
New Hampshire,1990,13,30.53846153846154,16.0,69.0,21,8
New Hampshire,1991,31,30.032258064516128,9.0,51.0,37,6
New Hampshire,1992,19,35.1578947368421,19.0,65.0,19,0
New Hampshire,1993,14,29.285714285714285,16.0,45.0,21,7
New Hampshire,1994,14,38.0,18.0,70.0,16,2
New Hampshire,1995,15,29.2,14.0,48.0,17,2
New Hampshire,1996,20,34.3,14.0,87.0,21,1
New Hampshire,1998,13,35.92307692307692,18.0,77.0,16,3
New Hampshire,1999,20,32.85,17.0,53.0,20,0
New Hampshire,2000,14,34.714285714285715,21.0,58.0,15,1
New Hampshire,2001,16,33.0,17.0,73.0,19,3
New Hampshire,2002,13,35.30769230769231,8.0,66.0,14,1
New Hampshire,2003,11,35.36363636363637,20.0,45.0,11,0
New Hampshire,2004,13,38.53846153846154,21.0,75.0,14,1
New Hampshire,2005,17,30.941176470588236,19.0,80.0,18,1
New Hampshire,2006,12,30.083333333333332,18.0,47.0,12,0
New Hampshire,2007,9,38.55555555555556,21.0,64.0,11,2
New Hampshire,2008,12,38.583333333333336,20.0,60.0,13,1
New Hampshire,2009,8,33.875,19.0,76.0,11,3
New Hampshire,2010,12,34.416666666666664,19.0,65.0,13,1
New Hampshire,2011,14,31.285714285714285,18.0,55.0,17,3
New Hampshire,2012,13,37.38461538461539,20.0,64.0,15,2
New Hampshire,2013,21,41.57142857142857,19.0,70.0,23,2
New Hampshire,2014,15,40.06666666666667,22.0,61.0,16,1
New Hampshire,2015,13,39.76923076923077,17.0,62.0,15,2
New Hampshire,2016,18,42.111111111111114,17.0,87.0,20,2
New Hampshire,2017,18,32.44444444444444,15.0,85.0,18,0
New Hampshire,2018,21,36.476190476190474,19.0,58.0,24,3
New Hampshire,2019,41,38.73170731707317,11.0,91.0,43,2
New Hampshire,2020,21,36.61904761904762,20.0,82.0,24,3
New Hampshire,2021,21,38.523809523809526,16.0,77.0,23,2
New Jersey,1976,288,29.774305555555557,8.0,78.0,392,104
New Jersey,1977,313,32.03833865814696,10.0,82.0,431,118
New Jersey,1978,301,30.172757475083056,11.0,80.0,402,101
New Jersey,1979,318,30.72641509433962,9.0,86.0,490,172
New Jersey,1980,358,28.391061452513966,13.0,68.0,534,176
New Jersey,1981,367,30.55040871934605,12.0,86.0,567,200
New Jersey,1982,307,29.319218241042346,12.0,84.0,497,190
New Jersey,1983,289,30.242214532871973,14.0,79.0,415,126
New Jersey,1984,285,31.449122807017545,12.0,84.0,399,114
New Jersey,1985,287,30.21602787456446,7.0,81.0,419,132
New Jersey,1986,248,30.14516129032258,13.0,82.0,407,159
New Jersey,1987,239,28.98326359832636,9.0,74.0,365,126
New Jersey,1988,296,29.12162162162162,14.0,64.0,434,138
New Jersey,1989,266,30.018796992481203,14.0,78.0,406,140
New Jersey,1990,300,28.68,12.0,82.0,443,143
New Jersey,1991,277,28.187725631768952,14.0,89.0,421,144
New Jersey,1992,301,28.451827242524917,12.0,87.0,417,116
New Jersey,1993,286,29.22027972027972,9.0,80.0,433,147
New Jersey,1994,252,27.595238095238095,11.0,77.0,414,162
New Jersey,1995,284,28.422535211267604,12.0,80.0,423,139
New Jersey,1996,252,28.535714285714285,8.0,77.0,352,100
New Jersey,1997,249,27.269076305220885,12.0,67.0,358,109
New Jersey,1998,228,29.43859649122807,10.0,80.0,334,106
New Jersey,1999,213,29.779342723004696,13.0,79.0,296,83
New Jersey,2000,191,29.50785340314136,10.0,87.0,298,107
New Jersey,2001,224,29.821428571428573,15.0,74.0,355,131
New Jersey,2002,233,30.034334763948497,15.0,79.0,349,116
New Jersey,2003,296,30.263513513513512,10.0,82.0,421,125
New Jersey,2004,264,29.768939393939394,14.0,92.0,418,154
New Jersey,2005,250,28.636,12.0,81.0,434,184
New Jersey,2006,262,28.171755725190838,11.0,86.0,447,185
New Jersey,2007,217,28.37327188940092,9.0,90.0,390,173
New Jersey,2008,225,31.6,14.0,89.0,391,166
New Jersey,2009,173,31.393063583815028,15.0,89.0,334,161
New Jersey,2010,227,30.41409691629956,15.0,79.0,392,165
New Jersey,2011,210,29.909523809523808,14.0,88.0,398,188
New Jersey,2012,204,30.95098039215686,13.0,85.0,405,201
New Jersey,2013,212,30.117924528301888,13.0,83.0,420,208
New Jersey,2014,200,33.445,14.0,85.0,359,159
New Jersey,2015,185,33.832432432432434,16.0,99.0,372,187
New Jersey,2016,199,31.07035175879397,6.0,64.0,395,196
New Jersey,2017,172,32.48255813953488,16.0,80.0,346,174
New Jersey,2018,164,33.88414634146341,8.0,82.0,300,136
New Jersey,2019,173,32.861271676300575,13.0,86.0,277,104
New Jersey,2020,175,32.371428571428574,11.0,91.0,336,161
New Jersey,2021,86,30.697674418604652,17.0,62.0,142,56
New Mexico,1976,84,29.19047619047619,14.0,65.0,115,31
New Mexico,1977,79,30.696202531645568,17.0,62.0,91,12
New Mexico,1978,68,30.455882352941178,14.0,71.0,87,19
New Mexico,1979,80,30.425,8.0,80.0,125,45
New Mexico,1980,74,30.77027027027027,16.0,74.0,141,67
New Mexico,1981,3,27.0,19.0,39.0,4,1
New Mexico,1982,71,31.56338028169014,5.0,63.0,115,44
New Mexico,1983,63,32.6031746031746,15.0,70.0,81,18
New Mexico,1984,54,30.37037037037037,15.0,70.0,79,25
New Mexico,1985,111,29.864864864864863,10.0,69.0,138,27
New Mexico,1986,100,31.12,13.0,78.0,145,45
New Mexico,1987,88,30.59090909090909,8.0,69.0,131,43
New Mexico,1988,85,31.658823529411766,4.0,65.0,134,49
New Mexico,1989,78,34.69230769230769,14.0,85.0,108,30
New Mexico,1990,64,30.75,15.0,77.0,96,32
New Mexico,1991,85,27.576470588235296,13.0,79.0,115,30
New Mexico,1992,69,30.434782608695652,11.0,87.0,101,32
New Mexico,1993,77,29.454545454545453,14.0,61.0,102,25
New Mexico,1994,94,29.79787234042553,15.0,89.0,115,21
New Mexico,1995,79,29.139240506329113,14.0,69.0,120,41
New Mexico,1996,94,28.861702127659573,16.0,67.0,144,50
New Mexico,1997,78,28.628205128205128,15.0,64.0,114,36
New Mexico,1998,110,30.827272727272728,15.0,66.0,157,47
New Mexico,1999,105,29.65714285714286,8.0,68.0,147,42
New Mexico,2000,90,30.5,14.0,74.0,126,36
New Mexico,2001,78,31.78205128205128,16.0,64.0,98,20
New Mexico,2002,120,31.391666666666666,4.0,76.0,149,29
New Mexico,2003,87,31.402298850574713,17.0,68.0,113,26
New Mexico,2004,114,30.24561403508772,13.0,66.0,158,44
New Mexico,2005,103,30.446601941747574,13.0,72.0,139,36
New Mexico,2006,90,29.92222222222222,14.0,82.0,111,21
New Mexico,2007,122,30.549180327868854,14.0,68.0,164,42
New Mexico,2008,112,30.955357142857142,14.0,86.0,144,32
New Mexico,2009,113,29.920353982300885,10.0,65.0,156,43
New Mexico,2010,118,30.97457627118644,13.0,86.0,142,24
New Mexico,2011,105,31.457142857142856,14.0,70.0,132,27
New Mexico,2012,91,30.714285714285715,14.0,63.0,112,21
New Mexico,2013,98,33.02040816326531,14.0,78.0,119,21
New Mexico,2014,99,31.303030303030305,15.0,93.0,128,29
New Mexico,2015,95,32.578947368421055,15.0,89.0,105,10
New Mexico,2016,95,35.38947368421053,14.0,85.0,111,16
New Mexico,2017,129,29.627906976744185,14.0,96.0,166,37
New Mexico,2018,131,34.35114503816794,15.0,74.0,168,37
New Mexico,2019,133,32.2406015037594,15.0,85.0,171,38
New Mexico,2020,118,33.898305084745765,14.0,99.0,154,36
New Mexico,2021,125,30.592,1.0,63.0,193,68
New York,1976,559,30.48479427549195,5.0,81.0,1113,554
New York,1977,947,30.647307286166843,11.0,87.0,2020,1073
New York,1978,1013,28.515301085883515,8.0,85.0,1911,898
New York,1979,1076,28.656133828996282,2.0,85.0,2187,1111
New York,1980,1169,28.49529512403764,5.0,90.0,2197,1028
New York,1981,1005,28.69950248756219,13.0,92.0,1818,813
New York,1982,1065,28.60657276995305,10.0,76.0,1992,927
New York,1983,1106,29.087703435804702,7.0,80.0,2086,980
New York,1984,981,29.53822629969419,13.0,81.0,1829,848
New York,1985,893,29.698768197088466,12.0,88.0,1562,669
New York,1986,971,29.31925849639547,12.0,85.0,1682,711
New York,1987,937,29.03308431163287,3.0,81.0,1881,944
New York,1988,928,28.62823275862069,4.0,81.0,2143,1215
New York,1989,817,28.216646266829866,10.0,83.0,1963,1146
New York,1990,991,28.42986881937437,11.0,95.0,2268,1277
New York,1991,868,27.252304147465438,13.0,75.0,2411,1543
New York,1992,855,27.312280701754386,8.0,88.0,2447,1592
New York,1993,788,28.475888324873097,8.0,90.0,2511,1723
New York,1994,663,28.324283559577676,13.0,75.0,2062,1399
New York,1995,580,29.332758620689656,12.0,88.0,1601,1021
New York,1996,527,28.751423149905122,10.0,79.0,1355,828
New York,1997,497,29.74446680080483,11.0,77.0,1113,616
New York,1998,418,29.593301435406698,11.0,84.0,931,513
New York,1999,432,28.53935185185185,10.0,96.0,925,493
New York,2000,469,27.769722814498934,13.0,81.0,956,487
New York,2001,454,29.784140969162994,12.0,77.0,949,495
New York,2002,458,28.930131004366814,8.0,89.0,903,445
New York,2003,368,30.01086956521739,14.0,86.0,917,549
New York,2004,415,32.31566265060241,12.0,87.0,902,487
New York,2005,422,30.42654028436019,9.0,69.0,894,472
New York,2006,571,29.541155866900176,13.0,79.0,944,373
New York,2007,469,28.69509594882729,13.0,85.0,800,331
New York,2008,507,29.796844181459566,13.0,70.0,839,332
New York,2009,468,30.237179487179485,15.0,80.0,781,313
New York,2010,495,30.274747474747475,6.0,90.0,863,368
New York,2011,475,30.974736842105262,14.0,76.0,769,294
New York,2012,394,31.96954314720812,12.0,87.0,682,288
New York,2013,412,33.69417475728155,6.0,99.0,651,239
New York,2014,367,32.33242506811989,13.0,86.0,642,275
New York,2015,394,31.941624365482234,6.0,82.0,644,250
New York,2016,425,33.76,12.0,81.0,669,244
New York,2017,397,33.6272040302267,15.0,76.0,564,167
New York,2018,365,32.55068493150685,13.0,79.0,562,197
New York,2019,378,33.96031746031746,13.0,90.0,577,199
New York,2020,447,33.70022371364653,13.0,84.0,820,373
New York,2021,605,34.02314049586777,11.0,99.0,899,294
North Carolina,1976,532,33.78195488721804,11.0,82.0,607,75
North Carolina,1977,542,32.54059040590406,6.0,79.0,615,73
North Carolina,1978,522,32.770114942528735,9.0,92.0,604,82
North Carolina,1979,499,33.587174348697395,8.0,82.0,599,100
North Carolina,1980,538,33.45910780669145,5.0,84.0,628,90
North Carolina,1981,454,33.88325991189427,4.0,77.0,541,87
North Carolina,1982,483,31.865424430641824,10.0,82.0,563,80
North Carolina,1983,440,32.75,3.0,73.0,521,81
North Carolina,1984,393,34.045801526717554,9.0,83.0,495,102
North Carolina,1985,458,33.42139737991266,12.0,73.0,527,69
North Carolina,1986,436,33.03669724770642,9.0,82.0,519,83
North Carolina,1987,437,34.13729977116705,2.0,83.0,523,86
North Carolina,1988,410,32.76829268292683,9.0,86.0,507,97
North Carolina,1989,469,33.52238805970149,6.0,82.0,589,120
North Carolina,1990,548,31.593065693430656,8.0,82.0,704,156
North Carolina,1991,587,30.461669505962522,5.0,88.0,779,192
North Carolina,1992,570,29.436842105263157,9.0,86.0,728,158
North Carolina,1993,606,29.462046204620464,12.0,75.0,796,190
North Carolina,1994,598,29.645484949832777,4.0,90.0,785,187
North Carolina,1995,501,30.526946107784433,12.0,94.0,714,213
North Carolina,1996,466,31.111587982832617,11.0,80.0,638,172
North Carolina,1997,498,30.97590361445783,7.0,77.0,647,149
North Carolina,1998,488,29.985655737704917,4.0,87.0,633,145
North Carolina,1999,395,29.51139240506329,6.0,82.0,575,180
North Carolina,2000,370,30.997297297297298,7.0,83.0,570,200
North Carolina,2001,353,31.19830028328612,13.0,77.0,543,190
North Carolina,2002,396,31.232323232323232,10.0,82.0,572,176
North Carolina,2003,362,30.392265193370164,3.0,82.0,521,159
North Carolina,2004,341,32.085043988269796,12.0,85.0,503,162
North Carolina,2005,404,30.57920792079208,11.0,79.0,593,189
North Carolina,2006,372,30.841397849462364,12.0,79.0,560,188
North Carolina,2007,383,31.10704960835509,1.0,77.0,575,192
North Carolina,2008,408,32.129901960784316,14.0,84.0,619,211
North Carolina,2009,338,32.75739644970414,15.0,89.0,506,168
North Carolina,2010,333,33.066066066066064,15.0,80.0,468,135
North Carolina,2011,348,31.117816091954023,14.0,87.0,507,159
North Carolina,2012,367,32.762942779291556,13.0,70.0,503,136
North Carolina,2013,304,32.45723684210526,11.0,88.0,477,173
North Carolina,2014,325,33.83076923076923,11.0,90.0,493,168
North Carolina,2015,338,32.053254437869825,13.0,74.0,525,187
North Carolina,2016,396,33.44949494949495,13.0,86.0,619,223
North Carolina,2017,403,31.307692307692307,8.0,99.0,601,198
North Carolina,2018,359,32.8941504178273,13.0,82.0,510,151
North Carolina,2019,450,30.59777777777778,11.0,75.0,564,114
North Carolina,2020,597,31.59463986599665,12.0,86.0,809,212
North Carolina,2021,736,31.570652173913043,12.0,94.0,1020,284
North Dakota,1976,5,32.0,22.0,55.0,8,3
North Dakota,1977,3,25.666666666666668,22.0,32.0,3,0
North Dakota,1978,8,30.625,13.0,49.0,8,0
North Dakota,1979,11,26.454545454545453,15.0,69.0,11,0
North Dakota,1980,9,20.0,16.0,30.0,9,0
North Dakota,1981,11,30.727272727272727,17.0,53.0,15,4
North Dakota,1982,5,32.8,23.0,43.0,6,1
North Dakota,1983,14,36.642857142857146,24.0,63.0,15,1
North Dakota,1984,13,27.846153846153847,14.0,46.0,13,0
North Dakota,1985,3,37.666666666666664,24.0,57.0,7,4
North Dakota,1986,6,37.0,25.0,44.0,7,1
North Dakota,1987,8,22.5,14.0,33.0,10,2
North Dakota,1988,12,35.166666666666664,22.0,59.0,13,1
North Dakota,1989,2,35.5,19.0,52.0,3,1
North Dakota,1990,4,22.5,19.0,26.0,5,1
North Dakota,1991,3,32.0,25.0,39.0,4,1
North Dakota,1992,12,28.583333333333332,15.0,63.0,12,0
North Dakota,1993,11,30.727272727272727,11.0,59.0,11,0
North Dakota,1994,1,42.0,42.0,42.0,1,0
North Dakota,1995,5,29.4,15.0,76.0,5,0
North Dakota,1996,10,36.1,17.0,56.0,11,1
North Dakota,1997,7,43.857142857142854,30.0,87.0,7,0
North Dakota,1998,7,22.0,14.0,35.0,7,0
North Dakota,1999,7,31.142857142857142,19.0,44.0,7,0
North Dakota,2000,4,36.5,16.0,55.0,4,0
North Dakota,2001,7,35.285714285714285,21.0,48.0,9,2
North Dakota,2002,5,31.6,21.0,48.0,5,0
North Dakota,2003,8,41.75,18.0,56.0,8,0
North Dakota,2004,8,37.0,21.0,73.0,8,0
North Dakota,2005,11,37.72727272727273,19.0,58.0,11,0
North Dakota,2006,6,33.5,21.0,56.0,7,1
North Dakota,2007,12,28.083333333333332,15.0,52.0,13,1
North Dakota,2008,3,25.333333333333332,21.0,29.0,3,0
North Dakota,2009,9,36.55555555555556,18.0,78.0,9,0
North Dakota,2010,9,32.55555555555556,18.0,46.0,9,0
North Dakota,2011,14,35.857142857142854,20.0,56.0,14,0
North Dakota,2012,14,32.42857142857143,22.0,65.0,14,0
North Dakota,2013,11,36.36363636363637,21.0,48.0,11,0
North Dakota,2014,15,37.06666666666667,19.0,60.0,15,0
North Dakota,2015,15,34.06666666666667,18.0,51.0,17,2
North Dakota,2016,16,32.0625,21.0,55.0,16,0
North Dakota,2017,25,28.28,22.0,43.0,25,0
North Dakota,2018,33,35.63636363636363,18.0,85.0,33,0
North Dakota,2019,28,37.107142857142854,15.0,78.0,28,0
North Dakota,2020,36,31.63888888888889,17.0,56.0,37,1
North Dakota,2021,27,38.48148148148148,16.0,85.0,28,1
Ohio,1976,546,33.476190476190474,14.0,88.0,711,165
Ohio,1977,534,33.46067415730337,10.0,89.0,705,171
Ohio,1978,593,32.65261382799326,5.0,88.0,738,145
Ohio,1979,684,30.900584795321638,3.0,89.0,900,216
Ohio,1980,645,31.48062015503876,3.0,87.0,879,234
Ohio,1981,568,33.693661971830984,6.0,88.0,797,229
Ohio,1982,526,31.5893536121673,11.0,76.0,689,163
Ohio,1983,457,32.054704595185996,5.0,83.0,589,132
Ohio,1984,420,32.22380952380952,13.0,88.0,543,123
Ohio,1985,410,33.02439024390244,14.0,82.0,540,130
Ohio,1986,438,31.75799086757991,8.0,83.0,546,108
Ohio,1987,464,31.9375,4.0,76.0,605,141
Ohio,1988,436,32.0,6.0,89.0,559,123
Ohio,1989,459,31.021786492374726,10.0,99.0,632,173
Ohio,1990,433,31.54272517321016,8.0,90.0,634,201
Ohio,1991,490,28.918367346938776,11.0,78.0,738,248
Ohio,1992,484,28.725206611570247,10.0,87.0,686,202
Ohio,1993,431,28.761020881670532,11.0,99.0,631,200
Ohio,1994,437,28.702517162471395,12.0,78.0,623,186
Ohio,1995,362,29.665745856353592,10.0,87.0,553,191
Ohio,1996,330,27.596969696969698,11.0,81.0,496,166
Ohio,1997,245,27.97142857142857,11.0,78.0,380,135
Ohio,1998,257,30.879377431906615,11.0,72.0,377,120
Ohio,1999,256,32.94140625,8.0,88.0,372,116
Ohio,2000,238,29.76050420168067,12.0,74.0,372,134
Ohio,2001,284,28.911971830985916,7.0,81.0,452,168
Ohio,2002,322,31.02173913043478,5.0,91.0,504,182
Ohio,2003,326,30.552147239263803,13.0,82.0,497,171
Ohio,2004,322,30.152173913043477,1.0,85.0,495,173
Ohio,2005,360,30.961111111111112,11.0,78.0,565,205
Ohio,2006,340,29.63235294117647,1.0,99.0,526,186
Ohio,2007,351,30.33048433048433,10.0,80.0,505,154
Ohio,2008,321,30.50778816199377,13.0,99.0,487,166
Ohio,2009,362,32.55801104972376,1.0,99.0,520,158
Ohio,2010,309,30.64724919093851,11.0,99.0,481,172
Ohio,2011,321,31.439252336448597,1.0,75.0,499,178
Ohio,2012,318,33.355345911949684,14.0,99.0,475,157
Ohio,2013,295,32.07796610169491,13.0,86.0,474,179
Ohio,2014,313,32.108626198083066,10.0,99.0,455,142
Ohio,2015,332,31.051204819277107,1.0,83.0,506,174
Ohio,2016,417,31.916067146282973,12.0,99.0,653,236
Ohio,2017,451,31.991130820399114,12.0,99.0,713,262
Ohio,2018,338,33.16568047337278,1.0,99.0,563,225
Ohio,2019,346,32.054913294797686,13.0,82.0,532,186
Ohio,2020,443,32.270880361173816,9.0,99.0,787,344
Ohio,2021,431,30.85614849187935,11.0,99.0,825,394
Oklahoma,1976,175,31.925714285714285,11.0,77.0,204,29
Oklahoma,1977,180,32.45,10.0,75.0,216,36
Oklahoma,1978,206,32.029126213592235,10.0,89.0,253,47
Oklahoma,1979,277,33.95306859205776,13.0,73.0,311,34
Oklahoma,1980,270,31.937037037037037,11.0,72.0,320,50
Oklahoma,1981,265,32.64528301886792,13.0,78.0,316,51
Oklahoma,1982,310,32.31290322580645,14.0,77.0,378,68
Oklahoma,1983,227,31.559471365638768,11.0,83.0,272,45
Oklahoma,1984,219,32.22831050228311,10.0,90.0,264,45
Oklahoma,1985,239,32.87866108786611,7.0,77.0,283,44
Oklahoma,1986,245,31.76326530612245,6.0,86.0,285,40
Oklahoma,1987,215,32.5953488372093,5.0,89.0,268,53
Oklahoma,1988,212,30.88679245283019,3.0,70.0,265,53
Oklahoma,1989,198,32.388888888888886,3.0,88.0,240,42
Oklahoma,1990,224,32.379464285714285,12.0,88.0,272,48
Oklahoma,1991,212,29.504716981132077,12.0,69.0,246,34
Oklahoma,1992,184,29.782608695652176,13.0,68.0,221,37
Oklahoma,1993,243,31.218106995884774,11.0,81.0,301,58
Oklahoma,1994,206,28.961165048543688,13.0,71.0,259,53
Oklahoma,1995,377,29.405835543766578,8.0,76.0,416,39
Oklahoma,1996,193,31.575129533678755,14.0,87.0,235,42
Oklahoma,1997,204,30.034313725490197,7.0,71.0,249,45
Oklahoma,1998,175,31.21142857142857,14.0,80.0,215,40
Oklahoma,1999,208,31.4375,2.0,82.0,254,46
Oklahoma,2000,167,30.88622754491018,5.0,87.0,202,35
Oklahoma,2001,170,31.776470588235295,13.0,83.0,215,45
Oklahoma,2002,163,32.28834355828221,10.0,72.0,186,23
Oklahoma,2003,170,31.21764705882353,13.0,82.0,232,62
Oklahoma,2004,164,35.03658536585366,14.0,82.0,205,41
Oklahoma,2005,156,31.423076923076923,14.0,75.0,201,45
Oklahoma,2006,173,33.213872832369944,14.0,77.0,223,50
Oklahoma,2007,196,30.653061224489797,5.0,81.0,253,57
Oklahoma,2008,172,31.6453488372093,14.0,86.0,231,59
Oklahoma,2009,212,30.235849056603772,14.0,74.0,246,34
Oklahoma,2010,166,29.86144578313253,6.0,71.0,209,43
Oklahoma,2011,182,32.09340659340659,13.0,72.0,227,45
Oklahoma,2012,175,31.46857142857143,5.0,86.0,239,64
Oklahoma,2013,170,33.54705882352941,3.0,97.0,216,46
Oklahoma,2014,166,33.77710843373494,3.0,80.0,199,33
Oklahoma,2015,221,31.963800904977376,15.0,99.0,275,54
Oklahoma,2016,223,32.56502242152467,14.0,78.0,269,46
Oklahoma,2017,233,32.47639484978541,13.0,74.0,283,50
Oklahoma,2018,194,34.381443298969074,15.0,82.0,232,38
Oklahoma,2019,263,35.70722433460076,1.0,80.0,298,35
Oklahoma,2020,321,35.29595015576324,13.0,88.0,363,42
Oklahoma,2021,300,32.833333333333336,4.0,82.0,345,45
Oregan,1976,75,30.373333333333335,14.0,72.0,98,23
Oregan,1977,80,32.0125,13.0,83.0,106,26
Oregan,1978,88,34.56818181818182,14.0,75.0,121,33
Oregan,1979,83,32.1566265060241,10.0,77.0,112,29
Oregan,1980,98,33.16326530612245,14.0,76.0,141,43
Oregan,1981,89,31.202247191011235,15.0,72.0,118,29
Oregan,1982,107,32.02803738317757,13.0,87.0,143,36
Oregan,1983,85,34.36470588235294,14.0,75.0,113,28
Oregan,1984,118,31.983050847457626,8.0,82.0,147,29
Oregan,1985,103,31.902912621359224,10.0,65.0,133,30
Oregan,1986,143,32.83216783216783,11.0,78.0,184,41
Oregan,1987,121,30.06611570247934,8.0,87.0,166,45
Oregan,1988,116,32.87931034482759,14.0,79.0,161,45
Oregan,1989,125,33.456,8.0,77.0,148,23
Oregan,1990,116,31.637931034482758,13.0,85.0,125,9
Oregan,1991,123,31.08130081300813,6.0,64.0,163,40
Oregan,1992,130,33.41538461538462,12.0,77.0,163,33
Oregan,1993,126,30.515873015873016,14.0,81.0,154,28
Oregan,1994,144,32.90972222222222,12.0,98.0,178,34
Oregan,1995,115,31.234782608695653,3.0,90.0,146,31
Oregan,1996,114,32.8421052631579,14.0,90.0,139,25
Oregan,1997,98,31.214285714285715,11.0,64.0,113,15
Oregan,1998,114,31.087719298245613,14.0,67.0,140,26
Oregan,1999,67,32.76119402985075,14.0,68.0,95,28
Oregan,2000,57,35.98245614035088,18.0,84.0,71,14
Oregan,2001,85,32.741176470588236,18.0,78.0,102,17
Oregan,2002,62,32.95161290322581,14.0,64.0,76,14
Oregan,2003,63,33.095238095238095,17.0,87.0,78,15
Oregan,2004,90,32.455555555555556,15.0,84.0,105,15
Oregan,2005,76,34.53947368421053,13.0,76.0,97,21
Oregan,2006,89,35.752808988764045,16.0,91.0,107,18
Oregan,2007,64,35.40625,16.0,81.0,82,18
Oregan,2008,70,30.87142857142857,13.0,60.0,92,22
Oregan,2009,86,38.08139534883721,13.0,92.0,98,12
Oregan,2010,82,37.292682926829265,16.0,90.0,93,11
Oregan,2011,75,38.18666666666667,16.0,87.0,92,17
Oregan,2012,81,37.46913580246913,16.0,84.0,97,16
Oregan,2013,72,36.736111111111114,15.0,88.0,85,13
Oregan,2014,63,36.01587301587302,17.0,65.0,84,21
Oregan,2015,75,38.24,16.0,88.0,85,10
Oregan,2016,96,35.59375,16.0,85.0,111,15
Oregan,2017,122,35.377049180327866,12.0,89.0,131,9
Oregan,2018,99,37.292929292929294,13.0,77.0,115,16
Oregan,2019,129,35.27131782945737,12.0,86.0,148,19
Oregan,2020,138,34.44202898550725,11.0,88.0,173,35
Oregan,2021,186,33.95161290322581,16.0,88.0,241,55
Pennsylvania,1976,628,31.28503184713376,11.0,80.0,739,111
Pennsylvania,1977,537,31.828677839851025,8.0,86.0,687,150
Pennsylvania,1978,570,30.975438596491227,10.0,83.0,760,190
Pennsylvania,1979,578,31.56401384083045,10.0,83.0,755,177
Pennsylvania,1980,637,29.941915227629515,5.0,83.0,844,207
Pennsylvania,1981,590,31.089830508474577,14.0,88.0,759,169
Pennsylvania,1982,556,30.8705035971223,13.0,80.0,704,148
Pennsylvania,1983,457,31.592997811816193,13.0,72.0,613,156
Pennsylvania,1984,445,31.525842696629212,12.0,80.0,561,116
Pennsylvania,1985,459,32.08061002178649,10.0,77.0,581,122
Pennsylvania,1986,445,31.15730337078652,12.0,80.0,560,115
Pennsylvania,1987,404,31.826732673267326,14.0,83.0,524,120
Pennsylvania,1988,436,31.605504587155963,12.0,88.0,572,136
Pennsylvania,1989,529,29.368620037807183,9.0,90.0,745,216
Pennsylvania,1990,595,30.10420168067227,8.0,75.0,784,189
Pennsylvania,1991,576,28.756944444444443,14.0,77.0,733,157
Pennsylvania,1992,516,29.094961240310077,12.0,77.0,772,256
Pennsylvania,1993,559,29.10912343470483,13.0,91.0,834,275
Pennsylvania,1994,496,28.735887096774192,9.0,86.0,734,238
Pennsylvania,1995,491,29.45213849287169,13.0,79.0,725,234
Pennsylvania,1996,454,29.262114537444933,14.0,85.0,703,249
Pennsylvania,1997,492,31.910569105691057,14.0,92.0,739,247
Pennsylvania,1998,440,28.884090909090908,11.0,76.0,628,188
Pennsylvania,1999,463,28.479481641468684,7.0,78.0,596,133
Pennsylvania,2000,414,30.555555555555557,11.0,90.0,604,190
Pennsylvania,2001,407,29.83783783783784,15.0,81.0,657,250
Pennsylvania,2002,388,30.417525773195877,12.0,83.0,625,237
Pennsylvania,2003,374,30.494652406417114,13.0,88.0,661,287
Pennsylvania,2004,403,30.640198511166254,7.0,83.0,696,293
Pennsylvania,2005,472,29.889830508474578,9.0,90.0,785,313
Pennsylvania,2006,462,30.874458874458874,13.0,85.0,790,328
Pennsylvania,2007,445,29.40674157303371,13.0,87.0,794,349
Pennsylvania,2008,447,31.52572706935123,7.0,90.0,749,302
Pennsylvania,2009,486,31.84567901234568,11.0,82.0,741,255
Pennsylvania,2010,436,31.0802752293578,9.0,88.0,699,263
Pennsylvania,2011,399,32.661654135338345,15.0,92.0,689,290
Pennsylvania,2012,460,31.645652173913042,13.0,86.0,766,306
Pennsylvania,2013,383,34.06005221932115,6.0,89.0,667,284
Pennsylvania,2014,320,33.9125,15.0,92.0,646,326
Pennsylvania,2015,344,31.959302325581394,4.0,82.0,705,361
Pennsylvania,2016,360,33.85,14.0,83.0,734,374
Pennsylvania,2017,383,32.32375979112272,1.0,86.0,809,426
Pennsylvania,2018,438,34.12100456621005,12.0,91.0,845,407
Pennsylvania,2019,268,31.932835820895523,15.0,86.0,584,316
Pennsylvania,2020,99,30.78787878787879,8.0,74.0,272,173
Pennsylvania,2021,276,31.33695652173913,15.0,76.0,569,293
Rhode Island,1976,16,26.3125,10.0,48.0,24,8
Rhode Island,1977,27,27.444444444444443,12.0,47.0,33,6
Rhode Island,1978,26,29.192307692307693,9.0,48.0,36,10
Rhode Island,1979,24,30.041666666666668,17.0,55.0,31,7
Rhode Island,1980,32,30.09375,14.0,65.0,43,11
Rhode Island,1981,28,28.892857142857142,16.0,61.0,42,14
Rhode Island,1982,24,29.208333333333332,16.0,82.0,36,12
Rhode Island,1983,26,30.0,14.0,60.0,32,6
Rhode Island,1984,24,27.583333333333332,18.0,41.0,32,8
Rhode Island,1985,28,31.035714285714285,16.0,64.0,36,8
Rhode Island,1986,23,28.652173913043477,15.0,59.0,34,11
Rhode Island,1987,30,31.2,19.0,57.0,41,11
Rhode Island,1988,24,28.166666666666668,16.0,53.0,41,17
Rhode Island,1989,32,29.15625,15.0,51.0,51,19
Rhode Island,1990,33,29.454545454545453,15.0,78.0,48,15
Rhode Island,1991,24,32.041666666666664,18.0,44.0,38,14
Rhode Island,1992,23,30.73913043478261,14.0,65.0,37,14
Rhode Island,1993,31,26.032258064516128,16.0,56.0,41,10
Rhode Island,1994,29,29.17241379310345,14.0,52.0,44,15
Rhode Island,1995,19,26.894736842105264,16.0,57.0,32,13
Rhode Island,1996,19,31.210526315789473,15.0,77.0,25,6
Rhode Island,1997,19,30.42105263157895,14.0,52.0,27,8
Rhode Island,1998,17,28.764705882352942,18.0,43.0,25,8
Rhode Island,1999,20,31.2,19.0,57.0,36,16
Rhode Island,2000,29,25.862068965517242,13.0,42.0,45,16
Rhode Island,2001,24,29.708333333333332,17.0,75.0,40,16
Rhode Island,2002,26,31.0,14.0,50.0,41,15
Rhode Island,2003,15,25.8,13.0,50.0,25,10
Rhode Island,2004,13,31.923076923076923,18.0,51.0,30,17
Rhode Island,2005,14,31.928571428571427,16.0,50.0,34,20
Rhode Island,2006,16,34.0,20.0,59.0,28,12
Rhode Island,2007,14,31.5,17.0,65.0,19,5
Rhode Island,2008,20,27.5,16.0,65.0,31,11
Rhode Island,2009,17,29.647058823529413,18.0,39.0,32,15
Rhode Island,2010,20,29.8,19.0,50.0,30,10
Rhode Island,2011,11,26.90909090909091,16.0,35.0,20,9
Rhode Island,2012,27,30.703703703703702,16.0,54.0,37,10
Rhode Island,2013,20,36.25,18.0,73.0,31,11
Rhode Island,2014,20,33.8,17.0,60.0,27,7
Rhode Island,2015,21,35.523809523809526,21.0,52.0,31,10
Rhode Island,2016,24,38.375,19.0,80.0,31,7
Rhode Island,2017,15,30.933333333333334,17.0,57.0,21,6
Rhode Island,2018,10,38.9,16.0,58.0,17,7
Rhode Island,2019,19,34.8421052631579,16.0,66.0,26,7
Rhode Island,2020,20,30.8,18.0,73.0,32,12
Rhode Island,2021,26,31.692307692307693,17.0,74.0,40,14
South Carolina,1976,297,32.656565656565654,10.0,80.0,344,47
South Carolina,1977,318,33.13522012578616,10.0,75.0,373,55
South Carolina,1978,314,33.05732484076433,4.0,84.0,355,41
South Carolina,1979,369,33.013550135501355,6.0,85.0,391,22
South Carolina,1980,337,33.531157270029674,1.0,76.0,367,30
South Carolina,1981,299,33.725752508361204,11.0,74.0,336,37
South Carolina,1982,345,33.87826086956522,11.0,82.0,368,23
South Carolina,1983,299,34.953177257525084,13.0,77.0,333,34
South Carolina,1984,296,34.29054054054054,15.0,81.0,319,23
South Carolina,1985,303,32.478547854785475,11.0,84.0,323,20
South Carolina,1986,300,31.66,12.0,76.0,322,22
South Carolina,1987,294,32.57823129251701,11.0,87.0,326,32
South Carolina,1988,316,31.84493670886076,8.0,84.0,345,29
South Carolina,1989,297,33.4006734006734,9.0,85.0,336,39
South Carolina,1990,384,32.330729166666664,7.0,88.0,422,38
South Carolina,1991,362,30.334254143646408,13.0,83.0,382,20
South Carolina,1992,341,31.926686217008797,13.0,73.0,371,30
South Carolina,1993,374,29.75133689839572,15.0,82.0,392,18
South Carolina,1994,334,30.020958083832337,14.0,99.0,364,30
South Carolina,1995,278,32.068345323741006,9.0,75.0,301,23
South Carolina,1996,316,30.240506329113924,13.0,81.0,346,30
South Carolina,1997,297,29.791245791245792,13.0,81.0,324,27
South Carolina,1998,283,31.24028268551237,12.0,72.0,310,27
South Carolina,1999,244,30.35655737704918,11.0,84.0,278,34
South Carolina,2000,254,30.106299212598426,13.0,79.0,288,34
South Carolina,2001,288,31.583333333333332,12.0,83.0,333,45
South Carolina,2002,269,31.04832713754647,1.0,82.0,311,42
South Carolina,2003,274,30.996350364963504,14.0,79.0,308,34
South Carolina,2004,260,31.31153846153846,15.0,73.0,293,33
South Carolina,2005,276,32.19202898550725,13.0,82.0,321,45
South Carolina,2006,345,31.18840579710145,12.0,76.0,373,28
South Carolina,2007,310,29.20967741935484,9.0,65.0,369,59
South Carolina,2008,273,31.732600732600734,12.0,82.0,318,45
South Carolina,2009,270,30.233333333333334,12.0,79.0,315,45
South Carolina,2010,244,32.34426229508197,14.0,90.0,278,34
South Carolina,2011,291,32.00343642611684,14.0,99.0,334,43
South Carolina,2012,293,34.515358361774744,17.0,90.0,349,56
South Carolina,2013,275,31.89090909090909,12.0,99.0,318,43
South Carolina,2014,274,32.448905109489054,1.0,99.0,336,62
South Carolina,2015,337,31.991097922848663,13.0,84.0,428,91
South Carolina,2016,325,32.723076923076924,14.0,80.0,387,62
South Carolina,2017,357,30.30252100840336,14.0,87.0,409,52
South Carolina,2018,335,30.698507462686567,14.0,67.0,417,82
South Carolina,2019,394,30.66751269035533,11.0,90.0,490,96
South Carolina,2020,441,30.292517006802722,13.0,79.0,575,134
South Carolina,2021,480,30.041666666666668,4.0,99.0,605,125
South Dakota,1976,8,31.625,23.0,51.0,10,2
South Dakota,1977,11,29.363636363636363,18.0,67.0,12,1
South Dakota,1978,8,46.625,24.0,83.0,9,1
South Dakota,1979,9,31.333333333333332,15.0,62.0,10,1
South Dakota,1980,5,24.8,15.0,36.0,5,0
South Dakota,1981,9,24.333333333333332,17.0,44.0,10,1
South Dakota,1982,12,29.166666666666668,15.0,56.0,16,4
South Dakota,1983,8,27.0,14.0,34.0,11,3
South Dakota,1984,8,32.375,23.0,45.0,10,2
South Dakota,1985,7,30.0,20.0,55.0,9,2
South Dakota,1986,17,36.0,18.0,74.0,18,1
South Dakota,1987,8,27.0,17.0,46.0,11,3
South Dakota,1988,13,27.53846153846154,20.0,51.0,13,0
South Dakota,1989,8,30.0,9.0,56.0,8,0
South Dakota,1990,11,31.545454545454547,17.0,61.0,14,3
South Dakota,1991,12,27.083333333333332,15.0,47.0,12,0
South Dakota,1992,5,34.4,15.0,61.0,6,1
South Dakota,1993,20,32.45,15.0,66.0,21,1
South Dakota,1994,9,26.666666666666668,12.0,51.0,9,0
South Dakota,1995,12,29.333333333333332,15.0,48.0,13,1
South Dakota,1996,6,25.666666666666668,14.0,36.0,6,0
South Dakota,1997,5,37.4,19.0,54.0,5,0
South Dakota,1998,6,36.166666666666664,16.0,74.0,6,0
South Dakota,1999,13,29.076923076923077,14.0,68.0,14,1
South Dakota,2000,7,22.285714285714285,18.0,29.0,8,1
South Dakota,2001,10,34.1,17.0,58.0,10,0
South Dakota,2002,12,31.166666666666668,20.0,55.0,12,0
South Dakota,2003,11,28.818181818181817,15.0,52.0,11,0
South Dakota,2004,16,31.4375,18.0,88.0,16,0
South Dakota,2005,14,38.857142857142854,18.0,63.0,15,1
South Dakota,2006,7,41.57142857142857,19.0,52.0,11,4
South Dakota,2007,15,29.8,17.0,46.0,15,0
South Dakota,2008,24,41.458333333333336,20.0,80.0,24,0
South Dakota,2009,17,29.705882352941178,18.0,46.0,18,1
South Dakota,2010,16,31.1875,18.0,47.0,17,1
South Dakota,2011,18,34.166666666666664,14.0,54.0,19,1
South Dakota,2012,13,33.61538461538461,5.0,74.0,16,3
South Dakota,2013,10,25.6,19.0,36.0,13,3
South Dakota,2014,20,35.05,18.0,76.0,20,0
South Dakota,2015,26,33.73076923076923,19.0,54.0,30,4
South Dakota,2016,24,33.833333333333336,16.0,62.0,24,0
South Dakota,2017,26,31.192307692307693,18.0,49.0,26,0
South Dakota,2018,23,32.04347826086956,14.0,74.0,23,0
South Dakota,2019,34,34.705882352941174,15.0,76.0,34,0
South Dakota,2020,60,30.183333333333334,15.0,59.0,65,5
South Dakota,2021,42,33.5,18.0,60.0,46,4
Tennessee,1976,300,35.18333333333333,8.0,85.0,377,77
Tennessee,1977,242,33.21900826446281,13.0,81.0,314,72
Tennessee,1978,345,33.43768115942029,13.0,91.0,410,65
Tennessee,1979,371,34.9622641509434,12.0,84.0,439,68
Tennessee,1980,401,33.99501246882793,13.0,85.0,497,96
Tennessee,1981,348,33.18390804597701,4.0,85.0,426,78
Tennessee,1982,336,33.42559523809524,13.0,89.0,418,82
Tennessee,1983,326,32.09509202453988,15.0,85.0,393,67
Tennessee,1984,296,32.222972972972975,14.0,74.0,343,47
Tennessee,1985,313,32.05111821086262,14.0,95.0,387,74
Tennessee,1986,369,32.235772357723576,14.0,81.0,454,85
Tennessee,1987,342,31.780701754385966,13.0,77.0,404,62
Tennessee,1988,307,31.68729641693811,10.0,83.0,407,100
Tennessee,1989,310,31.348387096774193,12.0,83.0,371,61
Tennessee,1990,365,30.720547945205478,14.0,72.0,433,68
Tennessee,1991,325,29.393846153846155,13.0,87.0,401,76
Tennessee,1992,372,29.561827956989248,15.0,72.0,468,96
Tennessee,1993,356,28.528089887640448,12.0,93.0,468,112
Tennessee,1994,321,28.87538940809969,12.0,90.0,449,128
Tennessee,1995,320,29.41875,14.0,89.0,473,153
Tennessee,1996,309,28.93527508090615,10.0,84.0,423,114
Tennessee,1997,327,28.2782874617737,14.0,69.0,439,112
Tennessee,1998,293,30.696245733788395,13.0,81.0,436,143
Tennessee,1999,303,30.927392739273927,4.0,78.0,411,108
Tennessee,2000,311,31.739549839228296,9.0,84.0,435,124
Tennessee,2001,353,31.56373937677054,15.0,99.0,444,91
Tennessee,2002,388,32.41494845360825,14.0,83.0,457,69
Tennessee,2003,345,31.58550724637681,12.0,99.0,426,81
Tennessee,2004,328,31.40548780487805,13.0,99.0,382,54
Tennessee,2005,381,32.29133858267716,13.0,84.0,463,82
Tennessee,2006,362,30.803867403314918,13.0,99.0,444,82
Tennessee,2007,365,30.706849315068492,12.0,64.0,445,80
Tennessee,2008,369,30.907859078590786,13.0,79.0,436,67
Tennessee,2009,417,30.81534772182254,14.0,84.0,486,69
Tennessee,2010,327,32.92354740061162,14.0,76.0,397,70
Tennessee,2011,350,31.44857142857143,14.0,89.0,421,71
Tennessee,2012,363,33.57300275482093,10.0,83.0,440,77
Tennessee,2013,291,32.7319587628866,14.0,85.0,363,72
Tennessee,2014,314,32.254777070063696,13.0,77.0,414,100
Tennessee,2015,356,31.778089887640448,11.0,83.0,451,95
Tennessee,2016,423,30.955082742316783,12.0,87.0,535,112
Tennessee,2017,434,31.433179723502302,12.0,90.0,596,162
Tennessee,2018,406,31.93103448275862,12.0,77.0,546,140
Tennessee,2019,388,31.8659793814433,11.0,88.0,566,178
Tennessee,2020,448,31.517857142857142,4.0,81.0,747,299
Tennessee,2021,480,32.27291666666667,13.0,81.0,760,280
Texas,1976,1198,32.76627712854758,3.0,99.0,1490,292
Texas,1977,1335,32.71760299625468,3.0,84.0,1742,407
Texas,1978,1429,31.99440167949615,11.0,83.0,1883,454
Texas,1979,1643,31.452830188679247,6.0,91.0,2290,647
Texas,1980,1776,31.043355855855857,6.0,83.0,2402,626
Texas,1981,1701,32.0,3.0,82.0,2293,592
Texas,1982,1336,32.028443113772454,3.0,80.0,1848,512
Texas,1983,1752,31.26027397260274,7.0,89.0,2352,600
Texas,1984,1624,31.07512315270936,10.0,82.0,2208,584
Texas,1985,1659,30.78119349005425,10.0,88.0,2248,589
Texas,1986,1713,31.223584354932868,7.0,88.0,2347,634
Texas,1987,1479,32.08789722785666,5.0,88.0,2039,560
Texas,1988,1410,30.97872340425532,5.0,87.0,2009,599
Texas,1989,1514,30.622853368560104,8.0,83.0,2142,628
Texas,1990,1693,29.558771411695215,5.0,95.0,2485,792
Texas,1991,1845,29.338211382113823,11.0,89.0,2768,923
Texas,1992,1607,29.133789670192908,10.0,87.0,2359,752
Texas,1993,1597,28.195992485911084,12.0,89.0,2271,674
Texas,1994,1500,28.498,10.0,89.0,2121,621
Texas,1995,1195,29.78828451882845,10.0,99.0,1733,538
Texas,1996,1081,28.851988899167438,11.0,87.0,1549,468
Texas,1997,973,29.895169578622816,12.0,81.0,1428,455
Texas,1998,974,30.197125256673512,4.0,88.0,1448,474
Texas,1999,876,29.399543378995435,11.0,87.0,1268,392
Texas,2000,902,30.426829268292682,9.0,90.0,1308,406
Texas,2001,951,30.46267087276551,10.0,90.0,1387,436
Texas,2002,931,31.00107411385607,8.0,97.0,1383,452
Texas,2003,1041,30.82804995196926,10.0,85.0,1510,469
Texas,2004,929,31.181916038751346,10.0,90.0,1431,502
Texas,2005,1004,30.89840637450199,13.0,84.0,1480,476
Texas,2006,994,30.792756539235413,9.0,84.0,1464,470
Texas,2007,1017,31.406096361848576,13.0,88.0,1533,516
Texas,2008,1028,31.29669260700389,12.0,89.0,1478,450
Texas,2009,1051,31.305423406279733,12.0,89.0,1470,419
Texas,2010,1023,33.45650048875855,12.0,90.0,1363,340
Texas,2011,886,33.034988713318285,12.0,85.0,1217,331
Texas,2012,935,32.19144385026738,11.0,90.0,1267,332
Texas,2013,962,32.603950103950105,12.0,99.0,1272,310
Texas,2014,966,33.484472049689444,13.0,90.0,1324,358
Texas,2015,1063,33.587958607714015,11.0,99.0,1436,373
Texas,2016,1129,32.17094774136404,10.0,99.0,1597,468
Texas,2017,1127,33.453416149068325,4.0,90.0,1581,454
Texas,2018,1154,33.378682842287695,1.0,91.0,1453,299
Texas,2019,1227,33.462917685411576,5.0,85.0,1549,322
Texas,2020,1617,31.824984539270254,6.0,92.0,2140,523
Texas,2021,1800,31.06222222222222,9.0,85.0,2365,565
Utah,1976,30,30.266666666666666,16.0,53.0,41,11
Utah,1977,27,43.25925925925926,20.0,87.0,36,9
Utah,1978,36,29.555555555555557,14.0,56.0,49,13
Utah,1979,44,33.29545454545455,15.0,74.0,54,10
Utah,1980,36,27.5,9.0,60.0,53,17
Utah,1981,44,28.65909090909091,15.0,64.0,54,10
Utah,1982,42,28.642857142857142,17.0,59.0,55,13
Utah,1983,49,27.93877551020408,11.0,57.0,56,7
Utah,1984,41,33.51219512195122,15.0,75.0,49,8
Utah,1985,41,31.24390243902439,13.0,73.0,53,12
Utah,1986,44,32.15909090909091,14.0,90.0,55,11
Utah,1987,46,30.391304347826086,15.0,59.0,56,10
Utah,1988,39,34.0,12.0,67.0,48,9
Utah,1989,34,33.44117647058823,17.0,73.0,46,12
Utah,1990,48,32.458333333333336,13.0,90.0,53,5
Utah,1991,38,30.789473684210527,13.0,61.0,55,17
Utah,1992,44,31.113636363636363,15.0,67.0,54,10
Utah,1993,59,31.83050847457627,14.0,63.0,69,10
Utah,1994,60,27.966666666666665,12.0,82.0,70,10
Utah,1995,62,30.5,12.0,74.0,78,16
Utah,1996,57,27.263157894736842,13.0,78.0,67,10
Utah,1997,52,26.96153846153846,12.0,67.0,75,23
Utah,1998,52,30.307692307692307,15.0,77.0,66,14
Utah,1999,49,31.510204081632654,15.0,70.0,58,9
Utah,2000,48,29.8125,4.0,78.0,54,6
Utah,2001,72,31.77777777777778,17.0,79.0,82,10
Utah,2002,53,29.49056603773585,15.0,55.0,57,4
Utah,2003,50,33.76,10.0,86.0,61,11
Utah,2004,53,32.9622641509434,13.0,85.0,58,5
Utah,2005,55,32.6,15.0,99.0,60,5
Utah,2006,52,29.865384615384617,13.0,59.0,52,0
Utah,2007,57,31.105263157894736,15.0,61.0,65,8
Utah,2008,41,34.02439024390244,16.0,77.0,47,6
Utah,2009,37,34.7027027027027,6.0,77.0,41,4
Utah,2010,56,33.57142857142857,16.0,80.0,58,2
Utah,2011,53,37.0,9.0,87.0,55,2
Utah,2012,51,32.96078431372549,16.0,76.0,57,6
Utah,2013,45,35.93333333333333,15.0,70.0,51,6
Utah,2014,69,34.44927536231884,16.0,83.0,72,3
Utah,2015,53,31.471698113207548,15.0,89.0,61,8
Utah,2016,69,31.217391304347824,16.0,63.0,76,7
Utah,2017,77,32.58441558441559,15.0,76.0,82,5
Utah,2018,63,31.96825396825397,15.0,70.0,69,6
Utah,2019,70,32.542857142857144,14.0,69.0,79,9
Utah,2020,99,33.656565656565654,14.0,90.0,112,13
Utah,2021,87,32.89655172413793,15.0,70.0,98,11
Vermont,1976,10,23.7,15.0,43.0,12,2
Vermont,1977,3,33.666666666666664,23.0,41.0,3,0
Vermont,1978,10,34.6,18.0,57.0,12,2
Vermont,1979,5,33.2,15.0,70.0,5,0
Vermont,1980,9,18.0,14.0,27.0,9,0
Vermont,1981,7,30.571428571428573,16.0,38.0,9,2
Vermont,1982,2,47.0,41.0,53.0,5,3
Vermont,1983,6,30.166666666666668,19.0,54.0,6,0
Vermont,1984,11,29.0,18.0,65.0,14,3
Vermont,1985,14,45.785714285714285,23.0,80.0,17,3
Vermont,1986,10,28.8,15.0,46.0,12,2
Vermont,1987,12,32.083333333333336,19.0,64.0,16,4
Vermont,1988,10,29.0,14.0,48.0,12,2
Vermont,1989,8,34.875,22.0,56.0,11,3
Vermont,1990,14,29.428571428571427,18.0,49.0,14,0
Vermont,1991,14,30.928571428571427,18.0,57.0,14,0
Vermont,1992,9,23.77777777777778,15.0,51.0,11,2
Vermont,1993,10,35.0,16.0,55.0,13,3
Vermont,1994,5,33.6,20.0,48.0,6,1
Vermont,1995,11,40.18181818181818,27.0,79.0,13,2
Vermont,1996,14,48.857142857142854,16.0,79.0,16,2
Vermont,1997,7,41.714285714285715,21.0,79.0,9,2
Vermont,1998,9,38.44444444444444,22.0,61.0,12,3
Vermont,1999,19,32.21052631578947,17.0,75.0,20,1
Vermont,2000,9,30.333333333333332,17.0,50.0,10,1
Vermont,2001,7,29.714285714285715,20.0,34.0,7,0
Vermont,2002,13,27.0,18.0,58.0,13,0
Vermont,2003,15,34.8,18.0,54.0,15,0
Vermont,2004,15,35.53333333333333,18.0,71.0,16,1
Vermont,2005,9,36.22222222222222,17.0,68.0,10,1
Vermont,2006,14,35.642857142857146,19.0,61.0,14,0
Vermont,2007,13,30.076923076923077,15.0,63.0,13,0
Vermont,2008,18,34.77777777777778,14.0,59.0,18,0
Vermont,2009,6,38.666666666666664,27.0,51.0,8,2
Vermont,2010,7,42.285714285714285,19.0,63.0,7,0
Vermont,2011,7,41.57142857142857,22.0,71.0,11,4
Vermont,2012,10,40.1,25.0,51.0,10,0
Vermont,2013,10,47.4,24.0,79.0,11,1
Vermont,2014,11,48.36363636363637,23.0,70.0,11,0
Vermont,2015,11,33.63636363636363,23.0,51.0,11,0
Vermont,2016,13,42.69230769230769,20.0,80.0,14,1
Vermont,2017,16,38.875,26.0,61.0,18,2
Vermont,2018,9,38.666666666666664,20.0,70.0,11,2
Vermont,2019,15,43.333333333333336,16.0,90.0,19,4
Vermont,2020,16,36.1875,22.0,58.0,18,2
Vermont,2021,14,43.142857142857146,16.0,77.0,15,1
Virginia,1976,446,34.14798206278027,12.0,79.0,501,55
Virginia,1977,396,33.05050505050505,7.0,76.0,476,80
Virginia,1978,393,33.14503816793893,13.0,94.0,473,80
Virginia,1979,390,33.11794871794872,12.0,86.0,463,73
Virginia,1980,392,34.38775510204081,11.0,80.0,468,76
Virginia,1981,371,35.110512129380055,11.0,81.0,474,103
Virginia,1982,346,31.58092485549133,7.0,81.0,427,81
Virginia,1983,333,31.98198198198198,9.0,86.0,405,72
Virginia,1984,363,33.37465564738292,11.0,78.0,457,94
Virginia,1985,333,32.26126126126126,10.0,85.0,413,80
Virginia,1986,345,33.23768115942029,14.0,78.0,427,82
Virginia,1987,360,31.25,7.0,82.0,453,93
Virginia,1988,368,32.22554347826087,15.0,83.0,482,114
Virginia,1989,414,30.502415458937197,8.0,80.0,511,97
Virginia,1990,437,29.37070938215103,8.0,79.0,561,124
Virginia,1991,446,28.614349775784753,6.0,76.0,596,150
Virginia,1992,419,29.859188544152744,11.0,84.0,581,162
Virginia,1993,435,28.70574712643678,13.0,80.0,559,124
Virginia,1994,424,28.879716981132077,13.0,77.0,605,181
Virginia,1995,387,28.989664082687337,12.0,82.0,519,132
Virginia,1996,363,30.327823691460054,14.0,88.0,508,145
Virginia,1997,352,29.011363636363637,7.0,87.0,508,156
Virginia,1998,308,31.185064935064936,15.0,74.0,421,113
Virginia,1999,271,32.27306273062731,10.0,98.0,376,105
Virginia,2000,289,31.418685121107266,15.0,81.0,398,109
Virginia,2001,295,30.55593220338983,14.0,87.0,377,82
Virginia,2002,295,31.79322033898305,13.0,85.0,391,96
Virginia,2003,302,30.278145695364238,14.0,75.0,419,117
Virginia,2004,293,30.453924914675767,14.0,82.0,392,99
Virginia,2005,366,30.136612021857925,13.0,80.0,465,99
Virginia,2006,328,30.36890243902439,5.0,90.0,408,80
Virginia,2007,348,29.841954022988507,14.0,91.0,427,79
Virginia,2008,318,31.91823899371069,14.0,81.0,382,64
Virginia,2009,317,32.28706624605678,12.0,70.0,392,75
Virginia,2010,315,33.36507936507937,14.0,85.0,387,72
Virginia,2011,255,33.70196078431373,15.0,86.0,319,64
Virginia,2012,257,32.27237354085603,13.0,89.0,334,77
Virginia,2013,280,32.27857142857143,13.0,69.0,336,56
Virginia,2014,286,33.47552447552447,15.0,84.0,354,68
Virginia,2015,289,32.80276816608997,4.0,85.0,402,113
Virginia,2016,374,31.655080213903744,15.0,96.0,505,131
Virginia,2017,404,32.834158415841586,9.0,79.0,515,111
Virginia,2018,336,32.67857142857143,13.0,84.0,436,100
Virginia,2019,366,32.595628415300546,6.0,77.0,481,115
Virginia,2020,424,32.570754716981135,10.0,97.0,585,161
Virginia,2021,483,31.27536231884058,12.0,93.0,665,182
Washington,1976,130,31.23076923076923,9.0,94.0,162,32
Washington,1977,91,34.362637362637365,14.0,75.0,129,38
Washington,1978,120,32.666666666666664,11.0,73.0,164,44
Washington,1979,135,32.80740740740741,13.0,67.0,184,49
Washington,1980,161,31.36024844720497,11.0,81.0,222,61
Washington,1981,140,30.192857142857143,15.0,72.0,208,68
Washington,1982,137,29.583941605839417,12.0,73.0,192,55
Washington,1983,174,32.758620689655174,12.0,77.0,226,52
Washington,1984,149,32.95302013422819,15.0,73.0,216,67
Washington,1985,176,32.29545454545455,14.0,85.0,234,58
Washington,1986,165,30.64848484848485,13.0,88.0,225,60
Washington,1987,173,32.59537572254335,13.0,80.0,254,81
Washington,1988,210,31.12857142857143,10.0,85.0,273,63
Washington,1989,157,31.05095541401274,10.0,76.0,211,54
Washington,1990,188,32.026595744680854,12.0,83.0,249,61
Washington,1991,161,29.869565217391305,7.0,85.0,221,60
Washington,1992,208,29.97596153846154,13.0,80.0,274,66
Washington,1993,208,29.317307692307693,12.0,87.0,287,79
Washington,1994,242,28.359504132231404,9.0,82.0,317,75
Washington,1995,222,31.774774774774773,11.0,91.0,288,66
Washington,1996,210,30.9,13.0,78.0,258,48
Washington,1997,187,29.06417112299465,13.0,83.0,250,63
Washington,1998,164,31.817073170731707,13.0,80.0,215,51
Washington,1999,141,29.78014184397163,12.0,72.0,182,41
Washington,2000,170,31.21764705882353,14.0,87.0,203,33
Washington,2001,165,31.054545454545455,13.0,70.0,199,34
Washington,2002,168,32.51190476190476,12.0,71.0,208,40
Washington,2003,169,34.06508875739645,12.0,90.0,204,35
Washington,2004,172,32.29651162790697,14.0,70.0,208,36
Washington,2005,191,32.1151832460733,11.0,72.0,226,35
Washington,2006,174,31.45977011494253,12.0,93.0,207,33
Washington,2007,156,33.80769230769231,15.0,84.0,186,30
Washington,2008,160,31.74375,14.0,91.0,210,50
Washington,2009,173,33.225433526011564,14.0,82.0,207,34
Washington,2010,143,34.32167832167832,14.0,88.0,175,32
Washington,2011,152,34.30263157894737,13.0,79.0,183,31
Washington,2012,175,33.24,3.0,80.0,215,40
Washington,2013,168,32.94047619047619,15.0,81.0,194,26
Washington,2014,183,34.666666666666664,12.0,80.0,206,23
Washington,2015,178,34.87078651685393,16.0,89.0,224,46
Washington,2016,173,33.47976878612717,15.0,94.0,213,40
Washington,2017,192,32.109375,13.0,99.0,242,50
Washington,2018,206,34.820388349514566,4.0,94.0,255,49
Washington,2019,190,36.05263157894737,14.0,88.0,229,39
Washington,2020,268,32.850746268656714,1.0,78.0,337,69
Washington,2021,241,33.43153526970954,13.0,84.0,360,119
West Virginia,1976,102,35.8235294117647,11.0,85.0,108,6
West Virginia,1977,111,35.18018018018018,4.0,79.0,119,8
West Virginia,1978,121,37.421487603305785,11.0,81.0,130,9
West Virginia,1979,107,32.429906542056074,11.0,84.0,120,13
West Virginia,1980,113,34.557522123893804,16.0,69.0,134,21
West Virginia,1981,110,33.82727272727273,12.0,73.0,122,12
West Virginia,1982,99,34.25252525252525,15.0,75.0,107,8
West Virginia,1983,88,35.43181818181818,15.0,83.0,97,9
West Virginia,1984,83,33.72289156626506,14.0,83.0,88,5
West Virginia,1985,73,35.21917808219178,14.0,68.0,75,2
West Virginia,1986,103,33.14563106796116,9.0,74.0,120,17
West Virginia,1987,98,35.42857142857143,14.0,84.0,104,6
West Virginia,1988,93,32.81720430107527,16.0,77.0,101,8
West Virginia,1989,106,32.264150943396224,13.0,68.0,125,19
West Virginia,1990,98,33.704081632653065,11.0,83.0,110,12
West Virginia,1991,103,32.80582524271845,12.0,71.0,112,9
West Virginia,1992,105,34.2,14.0,69.0,118,13
West Virginia,1993,112,30.5,13.0,67.0,129,17
West Virginia,1994,97,35.371134020618555,15.0,87.0,110,13
West Virginia,1995,85,32.37647058823529,15.0,64.0,92,7
West Virginia,1996,55,31.6,14.0,92.0,69,14
West Virginia,1997,77,31.61038961038961,13.0,67.0,85,8
West Virginia,1998,65,36.06153846153846,16.0,79.0,81,16
West Virginia,1999,62,35.725806451612904,1.0,66.0,69,7
West Virginia,2000,54,38.53703703703704,14.0,99.0,64,10
West Virginia,2001,35,35.82857142857143,18.0,98.0,40,5
West Virginia,2002,64,36.546875,16.0,97.0,76,12
West Virginia,2003,48,35.979166666666664,13.0,64.0,65,17
West Virginia,2004,53,34.509433962264154,14.0,73.0,66,13
West Virginia,2005,72,31.930555555555557,14.0,59.0,78,6
West Virginia,2006,71,39.54929577464789,15.0,69.0,76,5
West Virginia,2007,56,37.642857142857146,11.0,92.0,62,6
West Virginia,2008,56,37.589285714285715,18.0,74.0,64,8
West Virginia,2009,65,34.96923076923077,17.0,90.0,77,12
West Virginia,2010,49,34.06122448979592,13.0,60.0,57,8
West Virginia,2011,79,35.48101265822785,8.0,81.0,84,5
West Virginia,2012,65,37.53846153846154,16.0,83.0,72,7
West Virginia,2013,50,35.38,18.0,69.0,58,8
West Virginia,2014,69,37.57971014492754,16.0,83.0,74,5
West Virginia,2015,63,33.93650793650794,6.0,70.0,72,9
West Virginia,2016,60,38.483333333333334,15.0,83.0,80,20
West Virginia,2017,85,38.423529411764704,17.0,99.0,109,24
West Virginia,2018,53,34.58490566037736,12.0,65.0,65,12
West Virginia,2019,74,37.17567567567568,16.0,78.0,84,10
West Virginia,2020,108,39.51851851851852,13.0,87.0,120,12
West Virginia,2021,91,35.13186813186813,15.0,68.0,107,16
Wisconsin,1976,110,30.87272727272727,11.0,79.0,151,41
Wisconsin,1977,120,30.616666666666667,8.0,71.0,139,19
Wisconsin,1978,108,28.185185185185187,11.0,65.0,122,14
Wisconsin,1979,147,30.8843537414966,13.0,78.0,174,27
Wisconsin,1980,114,28.94736842105263,15.0,78.0,145,31
Wisconsin,1981,123,30.682926829268293,15.0,81.0,148,25
Wisconsin,1982,119,34.739495798319325,13.0,80.0,148,29
Wisconsin,1983,112,31.125,14.0,70.0,135,23
Wisconsin,1984,104,29.028846153846153,13.0,77.0,124,20
Wisconsin,1985,121,30.68595041322314,11.0,74.0,142,21
Wisconsin,1986,116,29.25,11.0,82.0,144,28
Wisconsin,1987,137,29.138686131386862,10.0,63.0,168,31
Wisconsin,1988,114,30.710526315789473,13.0,77.0,145,31
Wisconsin,1989,143,29.412587412587413,13.0,80.0,176,33
Wisconsin,1990,186,28.78494623655914,12.0,84.0,238,52
Wisconsin,1991,199,28.366834170854272,11.0,90.0,248,49
Wisconsin,1992,177,27.502824858757062,12.0,77.0,219,42
Wisconsin,1993,203,26.399014778325125,13.0,84.0,241,38
Wisconsin,1994,203,27.15270935960591,6.0,72.0,247,44
Wisconsin,1995,198,27.227272727272727,11.0,81.0,241,43
Wisconsin,1996,197,29.065989847715738,13.0,81.0,225,28
Wisconsin,1997,182,29.14835164835165,13.0,82.0,225,43
Wisconsin,1999,135,28.733333333333334,12.0,73.0,200,65
Wisconsin,2000,100,32.2,15.0,82.0,172,72
Wisconsin,2001,172,26.61046511627907,12.0,85.0,198,26
Wisconsin,2002,121,27.760330578512395,12.0,60.0,166,45
Wisconsin,2003,158,28.879746835443036,14.0,62.0,193,35
Wisconsin,2004,131,30.404580152671755,14.0,78.0,160,29
Wisconsin,2005,159,29.20125786163522,15.0,64.0,220,61
Wisconsin,2006,119,30.478991596638654,14.0,78.0,174,55
Wisconsin,2007,165,29.812121212121212,16.0,65.0,198,33
Wisconsin,2008,147,30.857142857142858,14.0,74.0,160,13
Wisconsin,2009,134,31.238805970149254,13.0,83.0,154,20
Wisconsin,2010,149,31.483221476510067,13.0,83.0,170,21
Wisconsin,2011,131,28.923664122137403,8.0,81.0,147,16
Wisconsin,2012,152,29.394736842105264,13.0,75.0,181,29
Wisconsin,2013,145,31.841379310344827,14.0,78.0,182,37
Wisconsin,2014,142,30.95774647887324,16.0,80.0,171,29
Wisconsin,2015,202,30.56930693069307,13.0,77.0,255,53
Wisconsin,2016,196,32.673469387755105,14.0,73.0,267,71
Wisconsin,2017,190,33.26315789473684,10.0,99.0,257,67
Wisconsin,2018,167,32.05988023952096,10.0,75.0,224,57
Wisconsin,2019,217,32.866359447004605,12.0,73.0,256,39
Wisconsin,2020,333,32.492492492492495,14.0,79.0,423,90
Wisconsin,2021,268,32.05597014925373,14.0,78.0,399,131
Wyoming,1976,19,33.05263157894737,16.0,59.0,22,3
Wyoming,1977,15,33.8,14.0,62.0,16,1
Wyoming,1978,23,33.56521739130435,19.0,75.0,24,1
Wyoming,1979,36,34.861111111111114,11.0,61.0,44,8
Wyoming,1980,29,28.724137931034484,14.0,63.0,34,5
Wyoming,1981,24,35.083333333333336,17.0,73.0,26,2
Wyoming,1982,27,29.962962962962962,15.0,52.0,34,7
Wyoming,1983,25,32.32,19.0,56.0,30,5
Wyoming,1984,16,29.625,12.0,54.0,20,4
Wyoming,1985,18,32.5,20.0,67.0,25,7
Wyoming,1986,27,28.11111111111111,16.0,42.0,29,2
Wyoming,1987,9,30.22222222222222,18.0,58.0,11,2
Wyoming,1988,11,35.0,24.0,49.0,14,3
Wyoming,1989,20,27.85,12.0,41.0,22,2
Wyoming,1990,22,35.59090909090909,15.0,75.0,23,1
Wyoming,1991,15,37.2,15.0,56.0,15,0
Wyoming,1992,19,28.68421052631579,17.0,46.0,20,1
Wyoming,1993,17,27.941176470588236,13.0,49.0,18,1
Wyoming,1994,19,31.05263157894737,15.0,62.0,20,1
Wyoming,1995,11,29.636363636363637,17.0,42.0,12,1
Wyoming,1996,16,38.4375,14.0,58.0,18,2
Wyoming,1997,18,36.22222222222222,18.0,76.0,18,0
Wyoming,1998,17,40.94117647058823,16.0,92.0,17,0
Wyoming,1999,12,32.916666666666664,19.0,58.0,13,1
Wyoming,2000,11,37.09090909090909,19.0,77.0,12,1
Wyoming,2001,9,34.333333333333336,19.0,49.0,11,2
Wyoming,2002,14,43.07142857142857,15.0,82.0,16,2
Wyoming,2003,17,30.647058823529413,19.0,54.0,17,0
Wyoming,2004,11,25.727272727272727,20.0,38.0,13,2
Wyoming,2005,17,32.0,18.0,74.0,17,0
Wyoming,2006,7,29.428571428571427,17.0,49.0,9,2
Wyoming,2007,17,26.58823529411765,18.0,46.0,18,1
Wyoming,2008,11,36.63636363636363,16.0,63.0,11,0
Wyoming,2009,12,34.416666666666664,15.0,51.0,12,0
Wyoming,2010,8,32.625,13.0,49.0,8,0
Wyoming,2011,17,29.352941176470587,17.0,38.0,20,3
Wyoming,2012,16,30.5,17.0,61.0,17,1
Wyoming,2013,17,31.294117647058822,15.0,66.0,17,0
Wyoming,2014,13,34.15384615384615,15.0,67.0,14,1
Wyoming,2015,15,32.2,23.0,53.0,18,3
Wyoming,2016,21,34.904761904761905,18.0,77.0,23,2
Wyoming,2017,14,38.714285714285715,20.0,74.0,14,0
Wyoming,2018,14,37.714285714285715,20.0,78.0,17,3
Wyoming,2019,12,33.75,21.0,51.0,15,3
Wyoming,2020,20,41.1,14.0,67.0,20,0
Wyoming,2021,23,34.95652173913044,4.0,64.0,33,10
