State,Year,VicAge_Count,VicAge_Mean,VicAge_Min,VicAge_Max,Incidents,N/A Age
Alabama,1976,484,37.02479338842975,0.0,80.0,504,20
Alabama,1977,498,36.708835341365464,0.0,92.0,504,6
Alabama,1978,491,35.79633401221996,2.0,90.0,493,2
Alabama,1979,484,37.349173553719005,0.0,90.0,487,3
Alabama,1980,512,37.205078125,0.0,90.0,513,1
Alabama,1981,452,36.18805309734513,0.0,92.0,453,1
Alabama,1982,422,36.343601895734594,0.0,93.0,424,2
Alabama,1983,369,36.8970189701897,0.0,86.0,372,3
Alabama,1984,379,36.78364116094987,0.0,83.0,382,3
Alabama,1985,395,36.870886075949365,0.0,90.0,397,2
Alabama,1986,407,35.59213759213759,0.0,94.0,407,0
Alabama,1987,336,35.06845238095238,0.0,88.0,336,0
Alabama,1988,389,36.34961439588689,0.0,91.0,389,0
Alabama,1989,415,35.860240963855425,0.0,92.0,416,1
Alabama,1990,461,35.32754880694143,0.0,94.0,463,2
Alabama,1991,406,33.532019704433495,1.0,90.0,434,28
Alabama,1992,377,35.856763925729446,1.0,91.0,391,14
Alabama,1993,450,33.25555555555555,1.0,92.0,477,27
Alabama,1994,467,33.389721627408996,1.0,92.0,501,34
Alabama,1995,446,35.23094170403587,1.0,99.0,467,21
Alabama,1996,398,33.65577889447236,0.0,98.0,430,32
Alabama,1997,368,35.08152173913044,1.0,96.0,415,47
Alabama,1998,289,34.95501730103806,2.0,87.0,343,54
Alabama,1999,14,34.42857142857143,1.0,78.0,15,1
Alabama,2000,218,37.174311926605505,1.0,87.0,235,17
Alabama,2001,312,34.705128205128204,0.0,88.0,347,35
Alabama,2002,271,36.68265682656826,1.0,93.0,292,21
Alabama,2003,274,34.7043795620438,1.0,81.0,295,21
Alabama,2004,235,35.46382978723404,1.0,84.0,253,18
Alabama,2005,317,34.59305993690852,0.0,88.0,327,10
Alabama,2006,344,35.372093023255815,1.0,91.0,358,14
Alabama,2007,375,33.632,0.0,86.0,392,17
Alabama,2008,326,33.65950920245399,1.0,85.0,342,16
Alabama,2009,307,34.57328990228013,1.0,89.0,318,11
Alabama,2010,175,36.2,1.0,90.0,191,16
Alabama,2011,324,34.385802469135804,0.0,91.0,339,15
Alabama,2012,304,35.85526315789474,3.0,88.0,333,29
Alabama,2013,318,36.257861635220124,2.0,90.0,367,49
Alabama,2014,287,36.45993031358885,1.0,91.0,349,62
Alabama,2015,411,35.051094890510946,1.0,86.0,445,34
Alabama,2016,445,33.853932584269664,1.0,91.0,493,48
Alabama,2017,539,35.62152133580705,1.0,99.0,575,36
Alabama,2018,471,34.76220806794055,1.0,91.0,502,31
Alabama,2019,4,44.25,20.0,73.0,4,0
Alabama,2020,24,44.916666666666664,8.0,91.0,24,0
Alabama,2021,338,33.94378698224852,0.0,99.0,381,43
Alaska,1976,47,29.893617021276597,0.0,79.0,47,0
Alaska,1977,47,28.4468085106383,0.0,69.0,47,0
Alaska,1978,50,30.06,0.0,62.0,50,0
Alaska,1979,51,31.96078431372549,1.0,67.0,51,0
Alaska,1980,46,29.782608695652176,8.0,60.0,47,1
Alaska,1981,69,29.942028985507246,0.0,71.0,69,0
Alaska,1982,75,28.8,0.0,85.0,75,0
Alaska,1983,74,32.2027027027027,0.0,72.0,74,0
Alaska,1984,51,33.372549019607845,2.0,73.0,52,1
Alaska,1985,50,39.54,7.0,76.0,50,0
Alaska,1986,47,30.680851063829788,2.0,79.0,47,0
Alaska,1987,47,31.74468085106383,2.0,81.0,48,1
Alaska,1988,30,33.1,0.0,73.0,30,0
Alaska,1989,40,33.275,1.0,74.0,41,1
Alaska,1990,37,35.054054054054056,14.0,80.0,37,0
Alaska,1991,44,29.5,0.0,66.0,45,1
Alaska,1992,44,31.886363636363637,4.0,53.0,44,0
Alaska,1993,60,30.783333333333335,0.0,73.0,60,0
Alaska,1994,44,33.20454545454545,14.0,83.0,44,0
Alaska,1995,54,33.870370370370374,0.0,84.0,54,0
Alaska,1996,41,32.073170731707314,2.0,66.0,41,0
Alaska,1997,55,32.236363636363635,0.0,84.0,55,0
Alaska,1998,42,34.666666666666664,0.0,82.0,42,0
Alaska,1999,56,34.32142857142857,0.0,81.0,56,0
Alaska,2000,35,29.8,0.0,74.0,35,0
Alaska,2001,39,32.41025641025641,0.0,67.0,39,0
Alaska,2002,41,31.0,0.0,65.0,41,0
Alaska,2003,43,31.930232558139537,0.0,67.0,44,1
Alaska,2004,43,29.348837209302324,0.0,72.0,44,1
Alaska,2005,37,28.864864864864863,0.0,57.0,37,0
Alaska,2006,42,30.714285714285715,0.0,63.0,42,0
Alaska,2007,53,28.49056603773585,0.0,56.0,53,0
Alaska,2008,33,35.333333333333336,0.0,62.0,33,0
Alaska,2009,36,29.47222222222222,0.0,76.0,36,0
Alaska,2010,42,27.761904761904763,0.0,64.0,43,1
Alaska,2011,36,33.361111111111114,0.0,66.0,36,0
Alaska,2012,40,36.05,2.0,68.0,40,0
Alaska,2013,41,34.02439024390244,0.0,73.0,41,0
Alaska,2014,47,40.61702127659574,0.0,81.0,48,1
Alaska,2015,63,34.0,0.0,76.0,71,8
Alaska,2016,69,30.840579710144926,0.0,69.0,69,0
Alaska,2017,77,37.896103896103895,3.0,92.0,77,0
Alaska,2018,64,33.1875,0.0,70.0,64,0
Alaska,2019,78,36.88461538461539,1.0,70.0,78,0
Alaska,2020,56,36.5,0.0,72.0,56,0
Alaska,2021,31,36.87096774193548,0.0,73.0,31,0
Arizona,1976,167,34.377245508982035,0.0,86.0,169,2
Arizona,1977,228,33.25877192982456,0.0,80.0,231,3
Arizona,1978,238,32.357142857142854,0.0,86.0,242,4
Arizona,1979,229,35.54585152838428,0.0,87.0,233,4
Arizona,1980,285,33.43157894736842,0.0,90.0,293,8
Arizona,1981,232,38.31896551724138,0.0,93.0,237,5
Arizona,1982,243,33.56378600823045,1.0,92.0,247,4
Arizona,1983,223,35.210762331838566,1.0,89.0,225,2
Arizona,1984,241,32.90041493775934,0.0,91.0,248,7
Arizona,1985,258,33.87984496124031,0.0,98.0,264,6
Arizona,1986,310,33.409677419354836,0.0,88.0,321,11
Arizona,1987,261,34.984674329501914,0.0,87.0,266,5
Arizona,1988,293,33.48805460750853,0.0,83.0,306,13
Arizona,1989,274,33.37956204379562,0.0,85.0,291,17
Arizona,1990,298,33.214765100671144,0.0,90.0,301,3
Arizona,1991,305,31.38360655737705,0.0,79.0,308,3
Arizona,1992,339,31.404129793510325,0.0,83.0,345,6
Arizona,1993,359,31.389972144846798,0.0,82.0,362,3
Arizona,1994,433,31.13394919168591,0.0,84.0,438,5
Arizona,1995,463,30.41900647948164,0.0,91.0,478,15
Arizona,1996,384,31.950520833333332,0.0,90.0,390,6
Arizona,1997,396,31.507575757575758,0.0,95.0,401,5
Arizona,1998,390,30.815384615384616,0.0,88.0,396,6
Arizona,1999,417,31.762589928057555,0.0,83.0,424,7
Arizona,2000,383,34.56919060052219,0.0,88.0,385,2
Arizona,2001,441,30.46485260770975,0.0,90.0,448,7
Arizona,2002,438,31.079908675799086,0.0,80.0,446,8
Arizona,2003,472,33.08050847457627,0.0,94.0,482,10
Arizona,2004,447,33.31543624161074,0.0,93.0,458,11
Arizona,2005,466,31.506437768240342,0.0,84.0,473,7
Arizona,2006,501,31.17564870259481,0.0,95.0,509,8
Arizona,2007,497,30.601609657947687,0.0,84.0,516,19
Arizona,2008,438,33.74885844748859,0.0,89.0,453,15
Arizona,2009,366,33.939890710382514,0.0,83.0,370,4
Arizona,2010,386,34.0699481865285,0.0,87.0,400,14
Arizona,2011,375,35.437333333333335,0.0,99.0,379,4
Arizona,2012,363,36.112947658402206,0.0,88.0,365,2
Arizona,2013,376,34.35372340425532,0.0,99.0,383,7
Arizona,2014,311,34.07073954983923,0.0,89.0,313,2
Arizona,2015,344,35.372093023255815,0.0,89.0,344,0
Arizona,2016,391,35.51918158567775,0.0,99.0,394,3
Arizona,2017,475,35.02947368421053,0.0,90.0,484,9
Arizona,2018,420,35.50238095238095,0.0,94.0,425,5
Arizona,2019,395,35.22278481012658,0.0,91.0,398,3
Arizona,2020,513,34.73879142300195,0.0,89.0,523,10
Arizona,2021,498,33.833333333333336,0.0,89.0,501,3
Arkansas,1976,177,37.101694915254235,1.0,87.0,180,3
Arkansas,1977,167,36.70059880239521,0.0,81.0,168,1
Arkansas,1978,191,33.952879581151834,0.0,90.0,198,7
Arkansas,1979,203,34.80295566502463,0.0,85.0,206,3
Arkansas,1980,214,33.74766355140187,0.0,75.0,214,0
Arkansas,1981,206,38.359223300970875,0.0,93.0,209,3
Arkansas,1982,192,40.432291666666664,0.0,99.0,195,3
Arkansas,1983,199,36.94472361809045,0.0,94.0,199,0
Arkansas,1984,183,35.96174863387978,0.0,93.0,183,0
Arkansas,1985,185,36.108108108108105,1.0,85.0,188,3
Arkansas,1986,195,34.93846153846154,0.0,86.0,202,7
Arkansas,1987,186,35.88709677419355,1.0,90.0,187,1
Arkansas,1988,211,37.90995260663507,0.0,88.0,216,5
Arkansas,1989,218,34.0,0.0,88.0,219,1
Arkansas,1990,251,34.0996015936255,0.0,90.0,254,3
Arkansas,1991,268,33.33582089552239,0.0,84.0,269,1
Arkansas,1992,254,33.61417322834646,0.0,81.0,255,1
Arkansas,1993,263,33.89733840304182,0.0,92.0,264,1
Arkansas,1994,299,34.735785953177256,0.0,86.0,303,4
Arkansas,1995,266,32.661654135338345,0.0,91.0,267,1
Arkansas,1996,217,35.45161290322581,0.0,88.0,219,2
Arkansas,1997,253,35.0395256916996,0.0,95.0,255,2
Arkansas,1998,206,32.66990291262136,0.0,84.0,209,3
Arkansas,1999,151,34.33112582781457,0.0,93.0,151,0
Arkansas,2000,163,34.47239263803681,0.0,87.0,163,0
Arkansas,2001,146,29.938356164383563,0.0,75.0,147,1
Arkansas,2002,141,33.58156028368794,0.0,84.0,146,5
Arkansas,2003,151,33.503311258278146,0.0,94.0,157,6
Arkansas,2004,146,38.33561643835616,0.0,99.0,157,11
Arkansas,2005,172,33.145348837209305,0.0,91.0,181,9
Arkansas,2006,194,32.891752577319586,0.0,89.0,205,11
Arkansas,2007,191,34.638743455497384,1.0,89.0,198,7
Arkansas,2008,154,35.72077922077922,0.0,79.0,165,11
Arkansas,2009,160,38.45625,0.0,80.0,173,13
Arkansas,2010,131,37.49618320610687,0.0,83.0,141,10
Arkansas,2011,155,34.116129032258065,0.0,90.0,160,5
Arkansas,2012,170,35.923529411764704,0.0,94.0,176,6
Arkansas,2013,151,35.98675496688742,0.0,79.0,156,5
Arkansas,2014,161,38.36645962732919,2.0,86.0,169,8
Arkansas,2015,176,37.93181818181818,0.0,90.0,179,3
Arkansas,2016,217,35.71889400921659,0.0,85.0,218,1
Arkansas,2017,258,34.86434108527132,0.0,91.0,265,7
Arkansas,2018,233,37.06008583690987,1.0,89.0,241,8
Arkansas,2019,251,34.756972111553786,0.0,85.0,253,2
Arkansas,2020,338,35.053254437869825,0.0,87.0,340,2
Arkansas,2021,328,33.34451219512195,0.0,87.0,339,11
California,1976,2333,34.0728675525075,0.0,99.0,2372,39
California,1977,2473,33.35463000404367,0.0,95.0,2523,50
California,1978,2694,32.91239792130661,0.0,94.0,2747,53
California,1979,3002,32.50766155896069,0.0,99.0,3068,66
California,1980,3522,32.457978421351505,0.0,99.0,3590,68
California,1981,2837,32.426506873457875,0.0,93.0,2885,48
California,1982,2933,33.0763723150358,0.0,93.0,2976,43
California,1983,2800,33.17464285714286,0.0,99.0,2830,30
California,1984,2859,33.1196222455404,0.0,98.0,2888,29
California,1985,2954,32.902166553825325,0.0,99.0,2986,32
California,1986,3196,32.00187734668335,0.0,94.0,3260,64
California,1987,3103,32.30035449564937,0.0,98.0,3166,63
California,1988,3089,32.031401748138556,0.0,91.0,3135,46
California,1989,3371,30.894393355087512,0.0,97.0,3412,41
California,1990,3808,29.91360294117647,0.0,99.0,3862,54
California,1991,4084,29.681684622918706,0.0,95.0,4146,62
California,1992,4157,30.069761847486166,0.0,94.0,4195,38
California,1993,4326,30.232778548312528,0.0,98.0,4370,44
California,1994,3895,29.609242618741977,0.0,95.0,3962,67
California,1995,3709,29.56484227554597,0.0,98.0,3760,51
California,1996,3057,29.980045796532547,0.0,93.0,3101,44
California,1997,2737,30.399342345633904,0.0,99.0,2773,36
California,1998,2328,30.02963917525773,0.0,93.0,2353,25
California,1999,2110,31.02085308056872,0.0,94.0,2132,22
California,2000,2187,31.375400091449475,0.0,91.0,2219,32
California,2001,2343,30.53777208706786,0.0,94.0,2357,14
California,2002,2529,31.060498220640568,0.0,99.0,2549,20
California,2003,2566,30.925954793452846,0.0,94.0,2584,18
California,2004,2566,30.742010911925174,1.0,92.0,2566,0
California,2005,2630,30.763498098859316,0.0,92.0,2651,21
California,2006,2632,30.42211246200608,0.0,99.0,2649,17
California,2007,2418,30.74317617866005,0.0,95.0,2425,7
California,2008,2277,31.612209046991655,0.0,94.0,2291,14
California,2009,2123,31.45407442298634,0.0,97.0,2132,9
California,2010,1943,31.355120946989192,0.0,95.0,1948,5
California,2011,1924,32.99428274428274,0.0,99.0,1931,7
California,2012,2040,33.09656862745098,0.0,94.0,2047,7
California,2013,1929,33.58994297563505,0.0,99.0,1930,1
California,2014,1867,34.19014461703267,0.0,96.0,1872,5
California,2015,2033,34.522380718150515,0.0,94.0,2041,8
California,2016,2079,34.98893698893699,0.0,95.0,2087,8
California,2017,1985,35.573803526448366,0.0,97.0,1994,9
California,2018,1867,35.90412426352437,0.0,95.0,1879,12
California,2019,1813,35.87755102040816,0.0,93.0,1818,5
California,2020,2368,35.67440878378378,0.0,97.0,2379,11
California,2021,2395,35.48225469728601,0.0,99.0,2415,20
Colorado,1976,181,34.22099447513812,0.0,95.0,183,2
Colorado,1977,175,31.88,0.0,89.0,176,1
Colorado,1978,194,31.824742268041238,0.0,85.0,194,0
Colorado,1979,168,29.779761904761905,0.0,86.0,171,3
Colorado,1980,193,33.056994818652846,0.0,93.0,198,5
Colorado,1981,229,32.580786026200876,0.0,89.0,230,1
Colorado,1982,190,31.605263157894736,0.0,94.0,193,3
Colorado,1983,209,34.24401913875598,0.0,91.0,214,5
Colorado,1984,187,33.20320855614973,0.0,87.0,192,5
Colorado,1985,202,31.905940594059405,0.0,87.0,204,2
Colorado,1986,245,32.93877551020408,0.0,85.0,247,2
Colorado,1987,207,31.869565217391305,0.0,95.0,211,4
Colorado,1988,202,31.92079207920792,0.0,91.0,206,4
Colorado,1989,164,33.3780487804878,0.0,93.0,166,2
Colorado,1990,166,28.14457831325301,0.0,91.0,166,0
Colorado,1991,210,31.52857142857143,0.0,83.0,213,3
Colorado,1992,228,32.12719298245614,0.0,87.0,232,4
Colorado,1993,220,31.704545454545453,0.0,86.0,221,1
Colorado,1994,183,30.420765027322403,0.0,80.0,187,4
Colorado,1995,215,31.767441860465116,0.0,96.0,219,4
Colorado,1996,181,31.790055248618785,0.0,77.0,182,1
Colorado,1997,172,33.22674418604651,0.0,91.0,175,3
Colorado,1998,192,28.598958333333332,0.0,87.0,195,3
Colorado,1999,200,30.97,0.0,84.0,201,1
Colorado,2000,129,34.42635658914729,0.0,81.0,134,5
Colorado,2001,153,30.333333333333332,0.0,86.0,154,1
Colorado,2002,179,32.98324022346369,0.0,91.0,181,2
Colorado,2003,186,30.86021505376344,0.0,94.0,190,4
Colorado,2004,212,33.660377358490564,0.0,82.0,216,4
Colorado,2005,175,32.29142857142857,1.0,84.0,177,2
Colorado,2006,168,31.267857142857142,0.0,86.0,176,8
Colorado,2007,156,32.36538461538461,0.0,86.0,161,5
Colorado,2008,160,32.6875,0.0,87.0,160,0
Colorado,2009,156,34.55769230769231,0.0,90.0,165,9
Colorado,2010,145,33.324137931034485,0.0,84.0,145,0
Colorado,2011,166,34.3855421686747,0.0,87.0,167,1
Colorado,2012,172,34.7093023255814,0.0,90.0,172,0
Colorado,2013,186,37.376344086021504,0.0,89.0,186,0
Colorado,2014,164,34.701219512195124,0.0,83.0,165,1
Colorado,2015,186,36.75268817204301,0.0,90.0,189,3
Colorado,2016,208,36.33653846153846,0.0,95.0,208,0
Colorado,2017,248,35.42338709677419,0.0,95.0,252,4
Colorado,2018,246,34.58536585365854,0.0,97.0,248,2
Colorado,2019,270,36.39259259259259,0.0,91.0,275,5
Colorado,2020,348,34.32183908045977,0.0,94.0,349,1
Colorado,2021,432,36.1412037037037,0.0,97.0,433,1
Connecticut,1976,88,35.10227272727273,0.0,66.0,88,0
Connecticut,1977,119,32.705882352941174,0.0,84.0,120,1
Connecticut,1978,122,31.483606557377048,0.0,87.0,122,0
Connecticut,1979,122,32.450819672131146,0.0,84.0,122,0
Connecticut,1980,156,35.05769230769231,2.0,90.0,158,2
Connecticut,1981,152,30.855263157894736,0.0,81.0,155,3
Connecticut,1982,164,34.75609756097561,0.0,84.0,164,0
Connecticut,1983,129,29.62015503875969,0.0,75.0,130,1
Connecticut,1984,116,31.310344827586206,0.0,92.0,116,0
Connecticut,1985,123,32.89430894308943,1.0,83.0,124,1
Connecticut,1986,144,31.895833333333332,0.0,81.0,148,4
Connecticut,1987,161,32.91304347826087,0.0,89.0,162,1
Connecticut,1988,180,29.38888888888889,0.0,83.0,181,1
Connecticut,1989,197,31.79695431472081,0.0,92.0,197,0
Connecticut,1990,175,28.982857142857142,0.0,82.0,177,2
Connecticut,1991,170,31.41764705882353,0.0,89.0,172,2
Connecticut,1992,179,29.6536312849162,0.0,94.0,181,2
Connecticut,1993,221,30.262443438914026,0.0,84.0,222,1
Connecticut,1994,220,28.70909090909091,0.0,89.0,220,0
Connecticut,1995,155,28.438709677419354,0.0,88.0,156,1
Connecticut,1996,166,32.33132530120482,0.0,86.0,166,0
Connecticut,1997,131,29.6793893129771,0.0,82.0,132,1
Connecticut,1998,144,31.083333333333332,0.0,76.0,144,0
Connecticut,1999,117,32.41880341880342,0.0,73.0,117,0
Connecticut,2000,99,32.03030303030303,0.0,86.0,100,1
Connecticut,2001,112,31.553571428571427,0.0,94.0,112,0
Connecticut,2002,83,29.3855421686747,0.0,86.0,86,3
Connecticut,2003,109,37.596330275229356,0.0,97.0,110,1
Connecticut,2004,102,31.019607843137255,0.0,82.0,103,1
Connecticut,2005,110,31.29090909090909,0.0,76.0,111,1
Connecticut,2006,113,30.938053097345133,0.0,85.0,113,0
Connecticut,2007,107,31.261682242990656,0.0,80.0,109,2
Connecticut,2008,131,32.10687022900763,0.0,94.0,132,1
Connecticut,2009,106,30.31132075471698,0.0,82.0,106,0
Connecticut,2010,134,33.93283582089552,1.0,79.0,134,0
Connecticut,2011,127,29.41732283464567,0.0,90.0,130,3
Connecticut,2012,145,31.013793103448275,6.0,86.0,145,0
Connecticut,2013,91,28.9010989010989,0.0,87.0,93,2
Connecticut,2014,90,32.266666666666666,0.0,86.0,90,0
Connecticut,2015,111,35.189189189189186,0.0,79.0,111,0
Connecticut,2016,79,33.12658227848101,0.0,76.0,79,0
Connecticut,2017,117,32.76923076923077,0.0,80.0,117,0
Connecticut,2018,93,34.75268817204301,0.0,87.0,93,0
Connecticut,2019,116,38.63793103448276,2.0,93.0,116,0
Connecticut,2020,158,34.14556962025316,0.0,79.0,161,3
Connecticut,2021,163,33.785276073619634,0.0,91.0,164,1
Delaware,1976,39,37.05128205128205,0.0,82.0,39,0
Delaware,1977,31,44.774193548387096,4.0,92.0,32,1
Delaware,1978,40,31.45,0.0,66.0,40,0
Delaware,1979,34,38.14705882352941,2.0,80.0,34,0
Delaware,1980,43,30.093023255813954,0.0,65.0,44,1
Delaware,1981,41,35.53658536585366,1.0,76.0,41,0
Delaware,1982,36,28.61111111111111,1.0,61.0,36,0
Delaware,1983,27,35.74074074074074,1.0,83.0,27,0
Delaware,1984,23,31.73913043478261,6.0,73.0,24,1
Delaware,1985,32,33.9375,0.0,79.0,32,0
Delaware,1986,32,35.53125,1.0,78.0,32,0
Delaware,1987,32,36.1875,3.0,86.0,32,0
Delaware,1988,34,35.8235294117647,0.0,78.0,34,0
Delaware,1989,33,30.0,0.0,77.0,33,0
Delaware,1990,33,34.45454545454545,1.0,89.0,33,0
Delaware,1991,36,37.833333333333336,1.0,78.0,39,3
Delaware,1992,19,34.526315789473685,1.0,88.0,20,1
Delaware,1993,21,28.80952380952381,0.0,64.0,22,1
Delaware,1994,12,36.916666666666664,17.0,74.0,14,2
Delaware,1995,9,26.22222222222222,2.0,56.0,9,0
Delaware,1996,30,38.3,1.0,95.0,33,3
Delaware,1997,14,37.92857142857143,4.0,63.0,16,2
Delaware,1998,21,31.0,0.0,69.0,24,3
Delaware,1999,20,34.5,18.0,58.0,25,5
Delaware,2000,22,35.86363636363637,0.0,63.0,27,5
Delaware,2001,28,32.07142857142857,2.0,61.0,29,1
Delaware,2002,30,30.366666666666667,13.0,56.0,30,0
Delaware,2003,21,29.047619047619047,16.0,69.0,21,0
Delaware,2004,27,28.185185185185187,7.0,68.0,28,1
Delaware,2005,38,34.39473684210526,9.0,76.0,41,3
Delaware,2006,42,31.30952380952381,17.0,84.0,42,0
Delaware,2007,37,31.35135135135135,16.0,55.0,39,2
Delaware,2008,56,31.839285714285715,13.0,64.0,57,1
Delaware,2009,42,30.333333333333332,1.0,78.0,44,2
Delaware,2010,51,34.03921568627451,10.0,73.0,52,1
Delaware,2011,47,37.61702127659574,2.0,91.0,48,1
Delaware,2012,53,33.56603773584906,1.0,76.0,57,4
Delaware,2013,40,34.8,16.0,83.0,41,1
Delaware,2014,49,31.93877551020408,4.0,68.0,53,4
Delaware,2015,63,30.77777777777778,3.0,80.0,65,2
Delaware,2016,58,31.844827586206897,3.0,78.0,58,0
Delaware,2017,58,29.896551724137932,1.0,89.0,59,1
Delaware,2018,50,29.68,1.0,81.0,50,0
Delaware,2019,48,31.770833333333332,1.0,79.0,50,2
Delaware,2020,78,29.23076923076923,13.0,86.0,79,1
Delaware,2021,98,34.775510204081634,1.0,81.0,98,0
District of Columbia,1976,203,36.36945812807882,3.0,85.0,203,0
District of Columbia,1977,202,36.67821782178218,0.0,84.0,202,0
District of Columbia,1978,196,36.61224489795919,0.0,81.0,196,0
District of Columbia,1979,168,35.226190476190474,0.0,79.0,171,3
District of Columbia,1980,180,33.24444444444445,0.0,83.0,180,0
District of Columbia,1981,231,35.39393939393939,0.0,85.0,232,1
District of Columbia,1982,202,34.663366336633665,0.0,88.0,204,2
District of Columbia,1983,185,34.33513513513513,0.0,82.0,188,3
District of Columbia,1984,165,32.193939393939395,2.0,84.0,175,10
District of Columbia,1985,144,32.5,2.0,74.0,149,5
District of Columbia,1986,151,32.96026490066225,0.0,88.0,154,3
District of Columbia,1987,209,30.885167464114833,0.0,86.0,225,16
District of Columbia,1988,343,29.434402332361515,0.0,90.0,375,32
District of Columbia,1989,420,28.916666666666668,0.0,93.0,439,19
District of Columbia,1990,453,29.103752759381898,0.0,89.0,481,28
District of Columbia,1991,459,28.413943355119827,1.0,82.0,489,30
District of Columbia,1992,438,27.85159817351598,0.0,86.0,450,12
District of Columbia,1993,415,28.40963855421687,1.0,86.0,423,8
District of Columbia,1994,391,30.25063938618926,1.0,93.0,417,26
District of Columbia,1995,354,27.497175141242938,1.0,87.0,377,23
District of Columbia,1997,298,28.493288590604028,1.0,83.0,309,11
District of Columbia,2001,1,32.0,32.0,32.0,1,0
District of Columbia,2002,252,29.178571428571427,0.0,89.0,252,0
District of Columbia,2003,243,30.987654320987655,0.0,96.0,243,0
District of Columbia,2004,188,29.81382978723404,0.0,77.0,189,1
District of Columbia,2005,183,30.103825136612024,1.0,84.0,187,4
District of Columbia,2006,166,30.57831325301205,0.0,89.0,165,-1
District of Columbia,2007,172,30.488372093023255,1.0,76.0,174,2
District of Columbia,2009,155,30.36774193548387,0.0,85.0,157,2
District of Columbia,2010,134,30.35820895522388,0.0,69.0,134,0
District of Columbia,2011,115,30.530434782608694,15.0,91.0,116,1
District of Columbia,2013,115,32.321739130434786,0.0,73.0,115,0
District of Columbia,2014,114,33.31578947368421,0.0,88.0,114,0
District of Columbia,2015,172,31.46511627906977,0.0,65.0,172,0
District of Columbia,2016,150,31.30666666666667,0.0,74.0,150,0
District of Columbia,2017,125,33.88,0.0,81.0,125,0
District of Columbia,2018,161,31.751552795031056,0.0,71.0,161,0
District of Columbia,2019,178,31.191011235955056,0.0,70.0,178,0
District of Columbia,2020,219,31.360730593607308,0.0,81.0,219,0
District of Columbia,2021,255,32.9921568627451,0.0,84.0,259,4
Florida,1976,872,37.56192660550459,0.0,90.0,876,4
Florida,1977,876,37.37442922374429,0.0,94.0,880,4
Florida,1978,969,36.021671826625386,0.0,89.0,973,4
Florida,1979,1101,34.450499545867395,0.0,94.0,1110,9
Florida,1980,1466,34.93792633015007,0.0,97.0,1508,42
Florida,1981,1521,35.26955950032873,0.0,89.0,1586,65
Florida,1982,1431,35.280922431865825,0.0,99.0,1482,51
Florida,1983,1216,36.41200657894737,0.0,97.0,1262,46
Florida,1984,1248,34.791666666666664,0.0,93.0,1319,71
Florida,1985,1238,35.70193861066236,0.0,90.0,1308,70
Florida,1986,1350,34.77777777777778,0.0,99.0,1427,77
Florida,1987,1371,35.23486506199854,0.0,94.0,1410,39
Florida,1991,1,22.0,22.0,22.0,1,0
Florida,1992,1256,35.58359872611465,1.0,99.0,1257,1
Florida,1993,1326,33.98567119155354,1.0,99.0,1329,3
Florida,1994,1272,32.403301886792455,1.0,99.0,1278,6
Florida,1995,1113,34.283917340521114,1.0,99.0,1114,1
Florida,1996,1395,34.84014336917563,1.0,99.0,1425,30
Florida,1997,1055,36.195260663507106,1.0,99.0,1067,12
Florida,1998,1077,35.467966573816156,1.0,97.0,1085,8
Florida,1999,909,34.92959295929593,1.0,98.0,915,6
Florida,2000,815,34.282208588957054,0.0,99.0,814,-1
Florida,2001,927,35.50485436893204,0.0,99.0,926,-1
Florida,2002,960,33.70729166666667,0.0,92.0,959,-1
Florida,2003,976,34.596311475409834,0.0,91.0,975,-1
Florida,2004,1011,34.590504451038576,0.0,93.0,1010,-1
Florida,2005,960,33.264583333333334,0.0,94.0,959,-1
Florida,2006,1210,33.69917355371901,0.0,95.0,1209,-1
Florida,2007,1349,33.23276501111935,0.0,99.0,1348,-1
Florida,2008,1296,32.73456790123457,0.0,93.0,1294,-2
Florida,2009,1162,33.02323580034423,0.0,94.0,1161,-1
Florida,2010,1130,34.068141592920355,0.0,96.0,1129,-1
Florida,2011,1136,34.61795774647887,0.0,93.0,1135,-1
Florida,2012,1170,35.49145299145299,0.0,92.0,1169,-1
Florida,2013,1129,34.863596102745795,0.0,99.0,1127,-2
Florida,2014,1156,34.511245674740486,0.0,93.0,1155,-1
Florida,2015,1196,34.65468227424749,0.0,99.0,1195,-1
Florida,2016,1260,34.54761904761905,0.0,99.0,1259,-1
Florida,2017,1232,35.33116883116883,0.0,99.0,1231,-1
Florida,2018,1278,35.472613458528954,0.0,93.0,1277,-1
Florida,2019,1289,35.52055857253685,0.0,94.0,1288,-1
Florida,2020,1482,34.71255060728745,0.0,95.0,1481,-1
Florida,2021,775,35.4141935483871,0.0,99.0,776,1
Georgia,1976,521,36.08253358925144,0.0,90.0,525,4
Georgia,1977,501,36.243512974051896,0.0,90.0,503,2
Georgia,1978,560,37.11071428571429,0.0,99.0,566,6
Georgia,1979,634,35.709779179810724,0.0,97.0,640,6
Georgia,1980,469,35.405117270788914,0.0,79.0,475,6
Georgia,1981,466,35.64592274678112,0.0,87.0,491,25
Georgia,1982,545,35.56146788990826,0.0,95.0,574,29
Georgia,1983,417,35.57553956834533,0.0,87.0,424,7
Georgia,1984,496,35.006048387096776,0.0,85.0,511,15
Georgia,1985,539,34.55102040816327,0.0,91.0,557,18
Georgia,1986,638,35.78526645768025,0.0,95.0,652,14
Georgia,1987,575,34.54260869565218,0.0,91.0,593,18
Georgia,1988,713,33.41234221598878,0.0,99.0,731,18
Georgia,1989,793,34.94073139974779,0.0,89.0,805,12
Georgia,1990,719,33.98331015299026,0.0,90.0,737,18
Georgia,1991,725,32.384827586206896,0.0,90.0,733,8
Georgia,1992,674,33.20326409495549,0.0,88.0,681,7
Georgia,1993,757,33.05151915455746,0.0,84.0,764,7
Georgia,1994,689,31.88679245283019,0.0,94.0,699,10
Georgia,1995,647,33.07882534775889,0.0,92.0,660,13
Georgia,1996,641,32.4804992199688,0.0,87.0,644,3
Georgia,1997,512,33.306640625,0.0,87.0,523,11
Georgia,1998,526,32.48098859315589,0.0,90.0,531,5
Georgia,1999,511,31.863013698630137,0.0,98.0,527,16
Georgia,2000,507,31.93491124260355,0.0,86.0,508,1
Georgia,2001,562,32.1085409252669,0.0,90.0,575,13
Georgia,2002,593,31.892074198988194,0.0,94.0,603,10
Georgia,2003,628,32.296178343949045,0.0,87.0,643,15
Georgia,2004,536,33.53544776119403,0.0,88.0,549,13
Georgia,2005,519,35.188824662813104,0.0,90.0,532,13
Georgia,2006,580,33.36206896551724,0.0,93.0,586,6
Georgia,2007,680,32.127941176470586,0.0,91.0,696,16
Georgia,2008,656,32.614329268292686,0.0,99.0,664,8
Georgia,2009,576,34.47569444444444,0.0,94.0,584,8
Georgia,2010,561,32.805704099821746,0.0,92.0,565,4
Georgia,2011,553,33.69258589511754,0.0,92.0,557,4
Georgia,2012,576,34.201388888888886,0.0,90.0,584,8
Georgia,2013,564,34.44326241134752,0.0,87.0,567,3
Georgia,2014,603,32.57379767827529,0.0,85.0,608,5
Georgia,2015,589,31.757215619694396,0.0,81.0,605,16
Georgia,2016,687,32.85735080058224,0.0,89.0,691,4
Georgia,2017,716,33.100558659217874,0.0,91.0,726,10
Georgia,2018,634,33.55205047318612,0.0,92.0,638,4
Georgia,2019,484,34.142561983471076,0.0,85.0,488,4
Georgia,2020,600,34.181666666666665,0.0,93.0,606,6
Georgia,2021,783,33.62579821200511,0.0,97.0,794,11
Hawaii,1976,58,33.01724137931034,0.0,86.0,58,0
Hawaii,1977,61,35.34426229508197,0.0,77.0,61,0
Hawaii,1978,59,32.779661016949156,0.0,81.0,59,0
Hawaii,1979,67,34.44776119402985,17.0,76.0,67,0
Hawaii,1980,84,36.5,4.0,84.0,84,0
Hawaii,1981,46,30.934782608695652,1.0,76.0,46,0
Hawaii,1982,33,35.03030303030303,19.0,63.0,33,0
Hawaii,1983,57,31.649122807017545,0.0,77.0,57,0
Hawaii,1984,34,32.64705882352941,0.0,81.0,34,0
Hawaii,1985,43,32.76744186046512,0.0,59.0,43,0
Hawaii,1986,52,34.13461538461539,4.0,86.0,52,0
Hawaii,1987,53,35.509433962264154,0.0,84.0,53,0
Hawaii,1988,47,32.723404255319146,3.0,63.0,47,0
Hawaii,1989,50,30.1,0.0,81.0,51,1
Hawaii,1990,45,38.888888888888886,0.0,73.0,45,0
Hawaii,1991,45,29.68888888888889,0.0,76.0,46,1
Hawaii,1992,43,30.767441860465116,0.0,72.0,43,0
Hawaii,1993,44,36.95454545454545,0.0,87.0,44,0
Hawaii,1994,53,34.64150943396226,0.0,74.0,53,0
Hawaii,1995,58,36.293103448275865,0.0,79.0,58,0
Hawaii,1996,41,33.09756097560975,4.0,70.0,41,0
Hawaii,1997,48,34.541666666666664,0.0,73.0,48,0
Hawaii,1998,27,36.333333333333336,0.0,69.0,27,0
Hawaii,1999,43,37.30232558139535,0.0,81.0,43,0
Hawaii,2000,35,39.8,0.0,82.0,35,0
Hawaii,2001,36,40.5,0.0,81.0,36,0
Hawaii,2002,25,35.0,1.0,71.0,25,0
Hawaii,2003,22,30.818181818181817,0.0,84.0,23,1
Hawaii,2004,34,37.76470588235294,2.0,71.0,34,0
Hawaii,2005,25,37.2,0.0,82.0,25,0
Hawaii,2006,23,35.04347826086956,0.0,61.0,23,0
Hawaii,2007,26,41.96153846153846,14.0,82.0,26,0
Hawaii,2008,27,35.925925925925924,1.0,65.0,27,0
Hawaii,2009,24,36.041666666666664,0.0,58.0,24,0
Hawaii,2010,26,45.07692307692308,13.0,88.0,27,1
Hawaii,2011,24,42.25,0.0,79.0,24,0
Hawaii,2012,23,38.52173913043478,1.0,97.0,23,0
Hawaii,2013,24,30.708333333333332,0.0,76.0,24,0
Hawaii,2014,15,44.733333333333334,0.0,88.0,15,0
Hawaii,2015,30,46.06666666666667,3.0,70.0,31,1
Hawaii,2016,44,37.90909090909091,5.0,67.0,44,0
Hawaii,2017,42,40.142857142857146,0.0,77.0,42,0
Hawaii,2018,39,40.87179487179487,16.0,82.0,40,1
Hawaii,2019,31,42.03225806451613,0.0,90.0,33,2
Hawaii,2020,39,43.333333333333336,0.0,82.0,42,3
Hawaii,2021,7,32.857142857142854,15.0,60.0,8,1
Idaho,1976,48,32.625,3.0,76.0,48,0
Idaho,1977,51,38.254901960784316,2.0,79.0,51,0
Idaho,1978,46,33.95652173913044,0.0,77.0,46,0
Idaho,1979,55,33.90909090909091,2.0,74.0,56,1
Idaho,1980,30,26.7,0.0,84.0,30,0
Idaho,1981,45,31.866666666666667,3.0,73.0,45,0
Idaho,1982,24,35.166666666666664,0.0,99.0,25,1
Idaho,1983,36,30.22222222222222,13.0,80.0,36,0
Idaho,1984,37,34.0,0.0,81.0,37,0
Idaho,1985,24,37.708333333333336,12.0,68.0,24,0
Idaho,1986,32,35.125,0.0,83.0,32,0
Idaho,1987,34,33.470588235294116,0.0,65.0,35,1
Idaho,1988,33,35.15151515151515,1.0,91.0,35,2
Idaho,1989,28,36.67857142857143,1.0,77.0,28,0
Idaho,1990,34,31.676470588235293,0.0,72.0,34,0
Idaho,1991,17,35.529411764705884,0.0,76.0,17,0
Idaho,1992,36,31.5,0.0,72.0,38,2
Idaho,1993,32,32.75,0.0,84.0,32,0
Idaho,1994,40,31.075,0.0,65.0,40,0
Idaho,1995,48,35.229166666666664,0.0,84.0,48,0
Idaho,1996,49,34.10204081632653,0.0,83.0,50,1
Idaho,1997,43,38.72093023255814,0.0,75.0,43,0
Idaho,1998,35,35.371428571428574,0.0,83.0,36,1
Idaho,1999,26,21.73076923076923,0.0,52.0,26,0
Idaho,2000,17,34.411764705882355,14.0,51.0,17,0
Idaho,2001,33,34.42424242424242,0.0,73.0,33,0
Idaho,2002,35,29.97142857142857,1.0,78.0,36,1
Idaho,2003,27,37.333333333333336,1.0,84.0,28,1
Idaho,2004,32,34.28125,0.0,85.0,32,0
Idaho,2005,42,26.452380952380953,1.0,84.0,42,0
Idaho,2006,33,33.54545454545455,1.0,77.0,33,0
Idaho,2007,51,34.627450980392155,0.0,71.0,51,0
Idaho,2008,23,35.04347826086956,0.0,87.0,23,0
Idaho,2009,21,36.42857142857143,2.0,93.0,22,1
Idaho,2010,22,34.68181818181818,0.0,90.0,22,0
Idaho,2011,31,24.29032258064516,0.0,83.0,31,0
Idaho,2012,29,37.13793103448276,2.0,69.0,29,0
Idaho,2013,30,41.5,1.0,87.0,30,0
Idaho,2014,30,31.3,0.0,64.0,30,0
Idaho,2015,32,45.21875,21.0,81.0,32,0
Idaho,2016,47,29.76595744680851,0.0,92.0,47,0
Idaho,2017,48,35.083333333333336,0.0,82.0,48,0
Idaho,2018,37,36.108108108108105,5.0,91.0,37,0
Idaho,2019,40,38.625,0.0,87.0,40,0
Idaho,2020,48,43.604166666666664,0.0,94.0,49,1
Idaho,2021,46,37.28260869565217,0.0,73.0,46,0
Illinois,1976,1206,33.99336650082919,0.0,99.0,1214,8
Illinois,1977,1164,32.016323024054984,0.0,96.0,1173,9
Illinois,1978,1182,32.2258883248731,0.0,90.0,1191,9
Illinois,1979,1315,32.829657794676805,0.0,88.0,1323,8
Illinois,1980,1322,31.917549167927383,0.0,88.0,1323,1
Illinois,1981,1218,32.592775041050906,0.0,90.0,1221,3
Illinois,1982,1105,31.765610859728508,0.0,92.0,1108,3
Illinois,1983,1125,32.79022222222222,0.0,90.0,1128,3
Illinois,1984,254,34.61417322834646,0.0,95.0,254,0
Illinois,1985,225,32.54222222222222,0.0,83.0,227,2
Illinois,1986,848,31.90801886792453,0.0,94.0,850,2
Illinois,1987,342,33.888888888888886,0.0,95.0,343,1
Illinois,1988,998,31.541082164328657,0.0,90.0,1000,2
Illinois,1989,1083,30.51708217913204,0.0,97.0,1086,3
Illinois,1990,771,30.621271076523996,0.0,91.0,773,2
Illinois,1991,1288,30.244565217391305,0.0,94.0,1289,1
Illinois,1992,1259,29.62351072279587,0.0,89.0,1262,3
Illinois,1993,1012,29.368577075098813,0.0,91.0,1014,2
Illinois,1994,1201,28.241465445462115,0.0,99.0,1223,22
Illinois,1995,820,28.163414634146342,1.0,88.0,821,1
Illinois,1996,826,28.121065375302663,0.0,90.0,827,1
Illinois,1997,799,28.196495619524406,0.0,95.0,799,0
Illinois,1998,763,27.306684141546526,0.0,93.0,766,3
Illinois,1999,685,28.795620437956206,0.0,98.0,688,3
Illinois,2000,667,29.112443778110944,0.0,82.0,668,1
Illinois,2001,702,28.373219373219374,0.0,88.0,705,3
Illinois,2002,687,29.066957787481805,0.0,85.0,687,0
Illinois,2003,642,28.926791277258566,1.0,88.0,644,2
Illinois,2004,483,29.026915113871635,0.0,82.0,485,2
Illinois,2005,482,30.321576763485478,0.0,89.0,484,2
Illinois,2006,525,29.617142857142856,1.0,90.0,526,1
Illinois,2007,510,29.323529411764707,0.0,89.0,510,0
Illinois,2008,570,28.84561403508772,1.0,88.0,570,0
Illinois,2009,513,28.721247563352826,1.0,83.0,517,4
Illinois,2010,482,28.300829875518673,1.0,94.0,484,2
Illinois,2011,507,28.597633136094675,0.0,80.0,510,3
Illinois,2012,550,28.758181818181818,0.0,86.0,554,4
Illinois,2013,483,28.443064182194618,0.0,83.0,483,0
Illinois,2014,477,28.69182389937107,0.0,88.0,479,2
Illinois,2015,538,28.855018587360593,0.0,89.0,538,0
Illinois,2016,1010,29.396039603960396,0.0,91.0,1013,3
Illinois,2017,849,30.3321554770318,0.0,90.0,852,3
Illinois,2018,883,32.28199320498301,0.0,94.0,884,1
Illinois,2019,802,30.75561097256858,0.0,93.0,802,0
Illinois,2020,1069,30.939195509822262,0.0,96.0,1072,3
Illinois,2021,1010,31.92178217821782,0.0,81.0,1011,1
Indiana,1976,300,34.54666666666667,0.0,79.0,309,9
Indiana,1977,310,35.348387096774196,0.0,79.0,320,10
Indiana,1978,280,33.07142857142857,0.0,80.0,294,14
Indiana,1979,414,34.98792270531401,0.0,92.0,427,13
Indiana,1980,404,35.31435643564357,0.0,87.0,409,5
Indiana,1981,354,33.443502824858754,0.0,98.0,357,3
Indiana,1982,333,35.432432432432435,1.0,99.0,336,3
Indiana,1983,269,34.152416356877325,0.0,90.0,269,0
Indiana,1984,278,33.15107913669065,0.0,89.0,281,3
Indiana,1985,280,34.417857142857144,0.0,83.0,287,7
Indiana,1986,265,32.49433962264151,0.0,88.0,268,3
Indiana,1987,216,35.31944444444444,0.0,87.0,222,6
Indiana,1988,309,33.82200647249191,0.0,97.0,315,6
Indiana,1989,262,31.3206106870229,0.0,88.0,271,9
Indiana,1990,256,33.65234375,0.0,91.0,264,8
Indiana,1991,297,32.75084175084175,0.0,84.0,311,14
Indiana,1992,358,31.522346368715084,0.0,84.0,369,11
Indiana,1993,357,32.3921568627451,0.0,95.0,368,11
Indiana,1994,384,31.484375,0.0,91.0,395,11
Indiana,1995,374,31.16042780748663,0.0,86.0,380,6
Indiana,1996,310,30.306451612903224,0.0,86.0,311,1
Indiana,1997,382,32.010471204188484,0.0,93.0,394,12
Indiana,1998,402,32.14179104477612,0.0,90.0,408,6
Indiana,1999,329,30.519756838905774,0.0,88.0,335,6
Indiana,2000,294,30.95578231292517,0.0,94.0,308,14
Indiana,2001,373,31.723860589812332,0.0,89.0,381,8
Indiana,2002,330,31.13030303030303,0.0,94.0,335,5
Indiana,2003,321,31.221183800623052,0.0,81.0,330,9
Indiana,2004,301,33.04983388704319,0.0,84.0,308,7
Indiana,2005,344,31.334302325581394,0.0,95.0,347,3
Indiana,2006,347,32.07492795389049,0.0,87.0,352,5
Indiana,2007,337,33.439169139465875,0.0,91.0,346,9
Indiana,2008,319,32.28526645768025,0.0,85.0,320,1
Indiana,2009,300,34.45333333333333,1.0,92.0,306,6
Indiana,2010,284,32.45774647887324,0.0,87.0,291,7
Indiana,2011,303,33.24752475247525,0.0,92.0,307,4
Indiana,2012,306,34.16013071895425,0.0,95.0,307,1
Indiana,2013,347,32.14409221902017,0.0,89.0,350,3
Indiana,2014,333,31.66966966966967,0.0,84.0,337,4
Indiana,2015,288,31.68402777777778,0.0,82.0,291,3
Indiana,2016,373,33.13672922252011,0.0,96.0,375,2
Indiana,2017,404,32.777227722772274,0.0,87.0,408,4
Indiana,2018,399,33.097744360902254,0.0,80.0,405,6
Indiana,2019,345,31.55072463768116,0.0,88.0,350,5
Indiana,2020,537,30.705772811918063,0.0,89.0,546,9
Indiana,2021,486,33.58230452674897,1.0,82.0,495,9
Iowa,1976,59,31.93220338983051,0.0,80.0,60,1
Iowa,1977,50,33.58,0.0,81.0,50,0
Iowa,1978,72,34.5,0.0,88.0,73,1
Iowa,1979,60,33.18333333333333,0.0,80.0,60,0
Iowa,1980,62,30.43548387096774,0.0,86.0,63,1
Iowa,1981,78,32.65384615384615,1.0,87.0,79,1
Iowa,1982,64,35.578125,0.0,85.0,65,1
Iowa,1983,69,29.73913043478261,0.0,72.0,70,1
Iowa,1984,55,35.30909090909091,1.0,85.0,56,1
Iowa,1985,57,32.87719298245614,0.0,81.0,57,0
Iowa,1986,51,30.705882352941178,0.0,74.0,52,1
Iowa,1987,31,33.903225806451616,0.0,81.0,31,0
Iowa,1988,48,33.1875,0.0,81.0,48,0
Iowa,1989,57,31.24561403508772,0.0,76.0,57,0
Iowa,1990,52,32.69230769230769,0.0,87.0,52,0
Iowa,1992,22,27.181818181818183,0.0,45.0,24,2
Iowa,1993,34,36.38235294117647,0.0,89.0,35,1
Iowa,1994,46,33.32608695652174,1.0,88.0,48,2
Iowa,1995,56,30.535714285714285,0.0,83.0,56,0
Iowa,1996,58,29.879310344827587,0.0,57.0,58,0
Iowa,1997,41,31.4390243902439,0.0,83.0,43,2
Iowa,1998,49,32.816326530612244,0.0,81.0,49,0
Iowa,1999,52,35.63461538461539,1.0,73.0,52,0
Iowa,2000,51,30.215686274509803,0.0,82.0,52,1
Iowa,2001,52,36.63461538461539,0.0,94.0,53,1
Iowa,2002,49,32.97959183673469,0.0,94.0,49,0
Iowa,2003,51,28.49019607843137,0.0,62.0,51,0
Iowa,2004,47,34.638297872340424,0.0,63.0,47,0
Iowa,2005,41,30.658536585365855,0.0,70.0,42,1
Iowa,2006,54,33.833333333333336,13.0,93.0,54,0
Iowa,2007,42,38.30952380952381,0.0,82.0,43,1
Iowa,2008,77,30.83116883116883,0.0,88.0,79,2
Iowa,2009,43,35.0,0.0,64.0,44,1
Iowa,2010,39,35.15384615384615,0.0,68.0,39,0
Iowa,2011,47,34.04255319148936,0.0,68.0,47,0
Iowa,2012,50,31.36,0.0,70.0,51,1
Iowa,2013,42,33.61904761904762,0.0,90.0,42,0
Iowa,2014,63,40.46031746031746,0.0,97.0,63,0
Iowa,2015,78,31.76923076923077,0.0,77.0,79,1
Iowa,2016,79,35.936708860759495,0.0,91.0,79,0
Iowa,2017,112,35.080357142857146,0.0,84.0,112,0
Iowa,2018,45,33.17777777777778,0.0,72.0,45,0
Iowa,2019,63,29.317460317460316,0.0,69.0,64,1
Iowa,2020,124,33.66935483870968,0.0,99.0,124,0
Iowa,2021,92,39.59782608695652,2.0,83.0,95,3
Kansas,1976,97,34.31958762886598,0.0,85.0,98,1
Kansas,1977,140,34.17857142857143,1.0,91.0,141,1
Kansas,1978,126,33.67460317460318,0.0,84.0,127,1
Kansas,1979,132,31.234848484848484,1.0,79.0,133,1
Kansas,1980,161,29.279503105590063,0.0,84.0,163,2
Kansas,1981,163,34.14110429447853,0.0,79.0,165,2
Kansas,1982,143,36.55244755244755,0.0,89.0,144,1
Kansas,1983,143,33.61538461538461,0.0,99.0,146,3
Kansas,1984,95,33.578947368421055,0.0,91.0,96,1
Kansas,1985,125,30.864,0.0,77.0,128,3
Kansas,1986,101,32.386138613861384,1.0,95.0,103,2
Kansas,1987,101,33.801980198019805,1.0,85.0,106,5
Kansas,1988,35,37.0,17.0,91.0,38,3
Kansas,1989,77,34.84415584415584,1.0,87.0,81,4
Kansas,1990,93,33.89247311827957,1.0,99.0,98,5
Kansas,1991,150,31.326666666666668,1.0,87.0,156,6
Kansas,1992,154,31.883116883116884,1.0,90.0,162,8
Kansas,1993,29,31.0,14.0,95.0,30,1
Kansas,2000,48,30.958333333333332,0.0,85.0,49,1
Kansas,2001,80,32.15,0.0,86.0,80,0
Kansas,2002,75,31.96,0.0,86.0,75,0
Kansas,2003,91,31.681318681318682,0.0,85.0,93,2
Kansas,2004,74,34.608108108108105,0.0,85.0,75,1
Kansas,2005,100,34.3,0.0,82.0,100,0
Kansas,2006,129,32.18604651162791,0.0,71.0,129,0
Kansas,2007,106,31.12264150943396,0.0,88.0,106,0
Kansas,2008,111,29.63063063063063,0.0,85.0,112,1
Kansas,2009,126,29.674603174603174,0.0,73.0,127,1
Kansas,2010,106,34.235849056603776,0.0,88.0,107,1
Kansas,2011,117,32.18803418803419,0.0,78.0,117,0
Kansas,2012,90,35.03333333333333,0.0,79.0,90,0
Kansas,2013,118,32.355932203389834,0.0,73.0,118,0
Kansas,2014,92,32.73913043478261,0.0,99.0,93,1
Kansas,2015,127,31.929133858267715,0.0,77.0,127,0
Kansas,2016,103,36.09708737864078,0.0,87.0,103,0
Kansas,2017,135,36.2,0.0,86.0,138,3
Kansas,2018,124,32.99193548387097,0.0,88.0,124,0
Kansas,2019,107,35.55140186915888,0.0,83.0,107,0
Kansas,2020,95,31.936842105263157,0.0,78.0,95,0
Kansas,2021,94,33.04255319148936,0.0,84.0,95,1
Kentucky,1976,375,38.077333333333335,0.0,88.0,377,2
Kentucky,1977,361,34.498614958448755,0.0,94.0,361,0
Kentucky,1978,327,35.06422018348624,0.0,88.0,327,0
Kentucky,1979,341,36.592375366568916,0.0,82.0,341,0
Kentucky,1980,388,35.50515463917526,0.0,94.0,389,1
Kentucky,1981,265,35.40377358490566,0.0,78.0,266,1
Kentucky,1982,285,36.04210526315789,0.0,88.0,286,1
Kentucky,1983,268,37.1044776119403,0.0,91.0,269,1
Kentucky,1984,243,37.23868312757202,0.0,87.0,243,0
Kentucky,1985,260,37.70384615384615,0.0,90.0,261,1
Kentucky,1986,251,36.657370517928285,0.0,87.0,251,0
Kentucky,1987,93,35.81720430107527,0.0,87.0,93,0
Kentucky,1989,154,38.57142857142857,1.0,85.0,167,13
Kentucky,1990,240,37.125,0.0,89.0,248,8
Kentucky,1991,249,34.69477911646587,0.0,86.0,250,1
Kentucky,1992,213,35.87323943661972,0.0,87.0,218,5
Kentucky,1993,240,36.325,0.0,85.0,240,0
Kentucky,1994,86,32.72093023255814,0.0,87.0,86,0
Kentucky,1995,258,35.310077519379846,0.0,90.0,260,2
Kentucky,1996,222,33.66216216216216,0.0,87.0,224,2
Kentucky,1997,219,34.38356164383562,0.0,83.0,221,2
Kentucky,1998,121,34.77685950413223,0.0,90.0,124,3
Kentucky,1999,78,31.474358974358974,0.0,79.0,84,6
Kentucky,2000,72,33.083333333333336,0.0,78.0,73,1
Kentucky,2001,79,35.44303797468354,0.0,83.0,81,2
Kentucky,2002,86,31.674418604651162,0.0,63.0,87,1
Kentucky,2003,80,33.6125,1.0,85.0,82,2
Kentucky,2004,216,34.06018518518518,0.0,99.0,219,3
Kentucky,2005,176,34.66477272727273,0.0,76.0,180,4
Kentucky,2006,158,35.063291139240505,0.0,83.0,159,1
Kentucky,2007,207,36.29951690821256,0.0,86.0,209,2
Kentucky,2008,202,35.17821782178218,0.0,88.0,202,0
Kentucky,2009,189,35.70899470899471,0.0,83.0,190,1
Kentucky,2010,186,37.61827956989247,0.0,91.0,189,3
Kentucky,2011,160,38.20625,0.0,86.0,161,1
Kentucky,2012,209,36.55980861244019,0.0,89.0,211,2
Kentucky,2013,172,37.50581395348837,0.0,82.0,174,2
Kentucky,2014,168,37.125,0.0,87.0,168,0
Kentucky,2015,235,36.69787234042553,0.0,86.0,238,3
Kentucky,2016,277,36.24548736462094,0.0,88.0,279,2
Kentucky,2017,305,34.24590163934426,0.0,87.0,307,2
Kentucky,2018,262,35.286259541984734,0.0,87.0,265,3
Kentucky,2019,246,34.60162601626016,0.0,81.0,247,1
Kentucky,2020,365,34.36986301369863,0.0,82.0,366,1
Kentucky,2021,425,35.072941176470586,0.0,83.0,426,1
Louisiana,1976,485,33.95670103092783,0.0,90.0,512,27
Louisiana,1977,578,34.48096885813149,0.0,86.0,594,16
Louisiana,1978,624,33.50160256410256,0.0,88.0,645,21
Louisiana,1979,683,33.84333821376281,0.0,99.0,724,41
Louisiana,1980,523,34.05162523900574,0.0,91.0,549,26
Louisiana,1981,629,33.14467408585055,0.0,84.0,650,21
Louisiana,1982,648,31.285493827160494,0.0,89.0,670,22
Louisiana,1983,564,32.079787234042556,0.0,83.0,580,16
Louisiana,1984,511,34.354207436399214,0.0,94.0,521,10
Louisiana,1985,447,34.48098434004474,0.0,89.0,453,6
Louisiana,1986,519,33.08670520231214,0.0,93.0,529,10
Louisiana,1987,375,33.25333333333333,0.0,93.0,382,7
Louisiana,1988,445,31.480898876404495,0.0,92.0,452,7
Louisiana,1989,580,31.432758620689654,0.0,89.0,586,6
Louisiana,1990,603,31.6318407960199,0.0,86.0,611,8
Louisiana,1991,327,32.56574923547401,0.0,93.0,332,5
Louisiana,1992,676,30.254437869822485,0.0,85.0,690,14
Louisiana,1993,777,29.705276705276706,0.0,91.0,800,23
Louisiana,1994,854,30.557377049180328,0.0,97.0,865,11
Louisiana,1995,740,30.13243243243243,0.0,92.0,750,10
Louisiana,1996,732,30.031420765027324,0.0,86.0,737,5
Louisiana,1997,666,31.25975975975976,0.0,93.0,675,9
Louisiana,1998,563,31.234458259325045,0.0,90.0,567,4
Louisiana,1999,472,32.317796610169495,0.0,86.0,482,10
Louisiana,2000,553,30.3996383363472,0.0,85.0,558,5
Louisiana,2001,506,30.140316205533598,0.0,82.0,511,5
Louisiana,2002,572,31.062937062937063,0.0,80.0,577,5
Louisiana,2003,600,31.77,0.0,99.0,601,1
Louisiana,2004,583,30.711835334476845,0.0,90.0,586,3
Louisiana,2005,431,30.839907192575406,0.0,89.0,433,2
Louisiana,2006,502,31.247011952191237,0.0,95.0,516,14
Louisiana,2007,590,32.14237288135593,0.0,86.0,607,17
Louisiana,2008,409,30.87041564792176,0.0,91.0,419,10
Louisiana,2009,510,31.88235294117647,0.0,88.0,520,10
Louisiana,2010,485,31.851546391752578,0.0,88.0,493,8
Louisiana,2011,503,31.75347912524851,0.0,88.0,509,6
Louisiana,2012,508,30.338582677165356,0.0,99.0,511,3
Louisiana,2013,473,31.644820295983088,0.0,93.0,478,5
Louisiana,2014,447,32.02013422818792,0.0,92.0,452,5
Louisiana,2015,521,32.0595009596929,0.0,95.0,522,1
Louisiana,2016,568,32.75352112676056,0.0,89.0,578,10
Louisiana,2017,603,32.3698175787728,0.0,89.0,612,9
Louisiana,2018,572,33.29370629370629,0.0,83.0,578,6
Louisiana,2019,572,33.40559440559441,0.0,85.0,575,3
Louisiana,2020,727,31.953232462173315,0.0,95.0,736,9
Louisiana,2021,807,31.17472118959108,0.0,89.0,823,16
Maine,1976,26,42.26923076923077,1.0,92.0,26,0
Maine,1977,29,37.758620689655174,1.0,78.0,29,0
Maine,1978,34,37.35294117647059,0.0,90.0,34,0
Maine,1979,33,43.666666666666664,1.0,81.0,33,0
Maine,1980,36,30.63888888888889,0.0,67.0,36,0
Maine,1981,35,35.142857142857146,1.0,88.0,36,1
Maine,1982,25,30.04,10.0,56.0,25,0
Maine,1983,29,34.58620689655172,9.0,76.0,29,0
Maine,1984,21,27.238095238095237,3.0,63.0,21,0
Maine,1985,29,38.86206896551724,0.0,80.0,29,0
Maine,1986,24,37.791666666666664,3.0,89.0,24,0
Maine,1987,33,36.72727272727273,16.0,83.0,33,0
Maine,1988,36,37.69444444444444,8.0,90.0,36,0
Maine,1989,46,32.02173913043478,0.0,77.0,46,0
Maine,1990,18,30.72222222222222,0.0,73.0,18,0
Maine,1993,7,34.857142857142854,5.0,73.0,7,0
Maine,1994,32,36.53125,0.0,78.0,32,0
Maine,1995,26,38.42307692307692,0.0,73.0,26,0
Maine,1996,26,41.73076923076923,0.0,76.0,26,0
Maine,1997,22,31.045454545454547,0.0,79.0,22,0
Maine,1998,27,33.074074074074076,0.0,86.0,27,0
Maine,1999,26,33.23076923076923,0.0,74.0,26,0
Maine,2000,15,39.266666666666666,17.0,74.0,15,0
Maine,2001,21,41.04761904761905,5.0,88.0,21,0
Maine,2002,16,36.125,0.0,66.0,16,0
Maine,2003,16,36.375,1.0,78.0,16,0
Maine,2004,18,44.72222222222222,2.0,82.0,18,0
Maine,2005,20,42.5,14.0,98.0,20,0
Maine,2006,26,37.30769230769231,0.0,83.0,26,0
Maine,2007,26,37.65384615384615,0.0,76.0,26,0
Maine,2008,35,34.31428571428572,0.0,72.0,35,0
Maine,2009,27,39.25925925925926,0.0,80.0,27,0
Maine,2010,27,35.666666666666664,1.0,58.0,27,0
Maine,2011,35,40.142857142857146,12.0,81.0,35,0
Maine,2012,33,37.81818181818182,0.0,99.0,33,0
Maine,2013,30,43.13333333333333,2.0,78.0,30,0
Maine,2014,29,36.51724137931034,0.0,92.0,29,0
Maine,2015,28,39.57142857142857,0.0,75.0,28,0
Maine,2016,23,42.130434782608695,0.0,86.0,23,0
Maine,2017,31,44.16129032258065,2.0,76.0,33,2
Maine,2018,27,47.48148148148148,10.0,82.0,27,0
Maine,2019,26,43.30769230769231,1.0,87.0,26,0
Maine,2020,29,40.310344827586206,18.0,73.0,29,0
Maine,2021,30,32.266666666666666,0.0,70.0,30,0
Maryland,1976,363,33.578512396694215,0.0,83.0,366,3
Maryland,1977,350,34.09142857142857,0.0,93.0,352,2
Maryland,1978,337,33.50148367952522,0.0,83.0,337,0
Maryland,1979,420,35.9547619047619,0.0,93.0,420,0
Maryland,1980,431,31.83062645011601,0.0,92.0,432,1
Maryland,1981,450,32.33111111111111,0.0,88.0,452,2
Maryland,1982,446,32.7982062780269,0.0,92.0,452,6
Maryland,1983,384,32.973958333333336,0.0,93.0,386,2
Maryland,1984,372,32.293010752688176,0.0,91.0,375,3
Maryland,1985,355,31.760563380281692,0.0,93.0,360,5
Maryland,1986,399,33.19548872180451,0.0,89.0,406,7
Maryland,1987,369,32.989159891598916,0.0,91.0,372,3
Maryland,1988,456,30.05482456140351,0.0,86.0,459,3
Maryland,1989,553,31.115732368896925,0.0,92.0,558,5
Maryland,1990,577,30.604852686308494,0.0,84.0,578,1
Maryland,1991,583,30.312178387650086,0.0,97.0,585,2
Maryland,1992,621,30.185185185185187,0.0,94.0,623,2
Maryland,1993,659,29.056145675265554,0.0,87.0,662,3
Maryland,1994,612,30.473856209150327,0.0,95.0,616,4
Maryland,1995,620,30.05,0.0,91.0,622,2
Maryland,1996,594,29.937710437710436,0.0,89.0,598,4
Maryland,1997,518,30.198841698841697,0.0,99.0,522,4
Maryland,1998,492,30.601626016260163,0.0,91.0,528,36
Maryland,1999,438,28.525114155251142,0.0,79.0,442,4
Maryland,2000,452,31.420353982300885,0.0,81.0,462,10
Maryland,2001,478,29.58786610878661,0.0,79.0,485,7
Maryland,2002,529,29.860113421550096,0.0,88.0,546,17
Maryland,2003,529,29.76937618147448,0.0,89.0,542,13
Maryland,2004,535,29.357009345794392,0.0,89.0,539,4
Maryland,2005,573,30.909249563699827,0.0,88.0,576,3
Maryland,2006,566,30.051236749116608,0.0,86.0,571,5
Maryland,2007,577,29.415944540727903,0.0,85.0,581,4
Maryland,2008,530,29.873584905660376,0.0,83.0,536,6
Maryland,2009,463,31.922246220302377,0.0,91.0,469,6
Maryland,2010,443,32.270880361173816,0.0,88.0,445,2
Maryland,2011,424,32.264150943396224,0.0,93.0,429,5
Maryland,2012,400,32.27,0.0,91.0,403,3
Maryland,2013,405,31.204938271604938,0.0,86.0,406,1
Maryland,2014,337,33.525222551928785,0.0,93.0,337,0
Maryland,2015,495,32.04848484848485,0.0,95.0,495,0
Maryland,2016,494,32.68623481781376,0.0,91.0,495,1
Maryland,2017,556,31.848920863309353,0.0,97.0,559,3
Maryland,2018,489,33.789366053169736,0.0,89.0,495,6
Maryland,2019,575,31.558260869565217,0.0,82.0,575,0
Maryland,2020,512,32.181640625,0.0,96.0,513,1
Maryland,2021,482,33.48755186721991,0.0,92.0,488,6
Massachusetts,1976,178,33.54494382022472,0.0,84.0,178,0
Massachusetts,1977,163,35.644171779141104,0.0,84.0,164,1
Massachusetts,1978,211,33.7345971563981,0.0,95.0,211,0
Massachusetts,1979,209,32.483253588516746,0.0,92.0,211,2
Massachusetts,1980,222,33.909909909909906,0.0,86.0,223,1
Massachusetts,1981,200,35.935,0.0,92.0,203,3
Massachusetts,1982,217,32.63594470046083,0.0,87.0,217,0
Massachusetts,1983,197,32.11675126903553,0.0,82.0,197,0
Massachusetts,1984,196,35.55102040816327,0.0,89.0,196,0
Massachusetts,1985,187,33.716577540106954,0.0,85.0,188,1
Massachusetts,1986,163,34.282208588957054,0.0,82.0,163,0
Massachusetts,1987,143,32.79020979020979,0.0,82.0,145,2
Massachusetts,1988,153,28.176470588235293,0.0,79.0,154,1
Massachusetts,1989,171,31.36842105263158,0.0,87.0,172,1
Massachusetts,1990,181,29.414364640883978,0.0,80.0,186,5
Massachusetts,1991,207,31.420289855072465,0.0,90.0,214,7
Massachusetts,1992,180,29.822222222222223,0.0,80.0,180,0
Massachusetts,1993,209,29.076555023923444,0.0,85.0,210,1
Massachusetts,1994,203,31.463054187192117,0.0,89.0,205,2
Massachusetts,1995,207,31.753623188405797,0.0,85.0,213,6
Massachusetts,1996,157,30.477707006369428,0.0,89.0,161,4
Massachusetts,1997,124,31.806451612903224,0.0,81.0,126,2
Massachusetts,1998,119,29.92436974789916,0.0,99.0,123,4
Massachusetts,1999,117,31.00854700854701,0.0,82.0,119,2
Massachusetts,2000,114,29.94736842105263,0.0,68.0,119,5
Massachusetts,2001,145,28.924137931034483,0.0,80.0,151,6
Massachusetts,2002,166,31.09036144578313,0.0,85.0,171,5
Massachusetts,2003,142,32.07746478873239,0.0,86.0,143,1
Massachusetts,2004,170,28.81764705882353,0.0,83.0,172,2
Massachusetts,2005,172,30.587209302325583,1.0,97.0,178,6
Massachusetts,2006,185,30.583783783783783,0.0,73.0,188,3
Massachusetts,2007,185,28.4,0.0,79.0,187,2
Massachusetts,2008,163,29.957055214723926,0.0,68.0,166,3
Massachusetts,2009,172,30.78488372093023,0.0,86.0,173,1
Massachusetts,2010,217,30.06451612903226,0.0,81.0,219,2
Massachusetts,2011,183,32.24590163934426,2.0,91.0,184,1
Massachusetts,2012,120,35.03333333333333,7.0,88.0,122,2
Massachusetts,2013,135,32.71851851851852,0.0,89.0,136,1
Massachusetts,2014,130,32.92307692307692,6.0,84.0,132,2
Massachusetts,2015,131,32.06106870229008,2.0,79.0,131,0
Massachusetts,2016,133,34.81203007518797,3.0,95.0,133,0
Massachusetts,2017,178,34.93258426966292,2.0,89.0,178,0
Massachusetts,2018,137,34.37956204379562,5.0,79.0,140,3
Massachusetts,2019,155,34.79354838709678,1.0,88.0,156,1
Massachusetts,2020,166,33.55421686746988,15.0,84.0,167,1
Massachusetts,2021,151,37.079470198675494,12.0,91.0,152,1
Michigan,1976,1071,33.83473389355742,0.0,95.0,1074,3
Michigan,1977,927,34.707659115426104,0.0,92.0,928,1
Michigan,1978,884,34.19570135746606,0.0,90.0,886,2
Michigan,1979,854,33.223653395784545,0.0,94.0,857,3
Michigan,1980,972,33.748971193415635,0.0,91.0,973,1
Michigan,1981,902,34.39689578713969,0.0,88.0,906,4
Michigan,1982,885,34.68135593220339,0.0,93.0,889,4
Michigan,1983,900,33.913333333333334,0.0,99.0,902,2
Michigan,1984,896,34.012276785714285,0.0,99.0,899,3
Michigan,1985,1055,32.724170616113746,0.0,99.0,1066,11
Michigan,1986,1060,32.54150943396226,0.0,90.0,1067,7
Michigan,1987,1142,31.857267950963223,0.0,94.0,1153,11
Michigan,1988,1033,32.643756050338816,0.0,93.0,1037,4
Michigan,1989,1007,31.665342601787486,0.0,97.0,1016,9
Michigan,1990,994,31.044265593561367,0.0,89.0,997,3
Michigan,1991,1024,31.671875,0.0,95.0,1028,4
Michigan,1992,973,30.606372045220965,0.0,98.0,985,12
Michigan,1993,961,30.93860561914672,0.0,97.0,976,15
Michigan,1994,941,31.32943676939426,0.0,95.0,946,5
Michigan,1995,828,31.870772946859905,0.0,92.0,834,6
Michigan,1996,709,31.939351198871652,0.0,99.0,720,11
Michigan,1997,727,32.17881705639615,0.0,99.0,746,19
Michigan,1998,705,31.520567375886525,0.0,95.0,727,22
Michigan,1999,722,32.20775623268698,0.0,95.0,737,15
Michigan,2000,682,32.300586510263926,0.0,99.0,694,12
Michigan,2001,661,32.61875945537065,0.0,99.0,674,13
Michigan,2002,677,32.86706056129985,0.0,94.0,694,17
Michigan,2003,620,32.97258064516129,0.0,84.0,636,16
Michigan,2004,646,33.89164086687307,0.0,93.0,663,17
Michigan,2005,607,32.54530477759473,0.0,95.0,650,43
Michigan,2006,690,34.21739130434783,0.0,87.0,734,44
Michigan,2007,641,33.37597503900156,0.0,94.0,674,33
Michigan,2008,544,33.2389705882353,0.0,99.0,564,20
Michigan,2009,636,34.2311320754717,0.0,90.0,646,10
Michigan,2010,600,33.035,0.0,89.0,606,6
Michigan,2011,661,33.39939485627836,0.0,94.0,668,7
Michigan,2012,723,33.19917012448133,0.0,98.0,731,8
Michigan,2013,628,34.0828025477707,0.0,91.0,645,17
Michigan,2014,565,34.27433628318584,0.0,84.0,576,11
Michigan,2015,599,34.50751252086811,0.0,91.0,611,12
Michigan,2016,618,33.39967637540453,0.0,85.0,631,13
Michigan,2017,629,34.9268680445151,0.0,92.0,640,11
Michigan,2018,607,34.96375617792422,0.0,84.0,620,13
Michigan,2019,611,34.5253682487725,0.0,99.0,620,9
Michigan,2020,838,34.099045346062056,0.0,99.0,848,10
Michigan,2021,858,34.07692307692308,0.0,99.0,868,10
Minnesota,1976,108,32.53703703703704,0.0,86.0,109,1
Minnesota,1977,100,35.28,0.0,84.0,100,0
Minnesota,1978,77,30.25974025974026,0.0,76.0,77,0
Minnesota,1979,104,33.61538461538461,0.0,85.0,104,0
Minnesota,1980,112,32.49107142857143,0.0,93.0,112,0
Minnesota,1981,85,34.741176470588236,0.0,81.0,87,2
Minnesota,1982,99,31.161616161616163,0.0,86.0,99,0
Minnesota,1983,67,34.37313432835821,0.0,75.0,68,1
Minnesota,1984,76,30.82894736842105,0.0,86.0,76,0
Minnesota,1985,89,34.438202247191015,1.0,91.0,90,1
Minnesota,1986,101,35.396039603960396,0.0,86.0,101,0
Minnesota,1987,109,34.10091743119266,0.0,81.0,109,0
Minnesota,1988,120,33.641666666666666,0.0,91.0,121,1
Minnesota,1989,107,34.177570093457945,0.0,86.0,108,1
Minnesota,1990,64,35.390625,0.0,86.0,65,1
Minnesota,1991,116,32.48275862068966,0.0,86.0,116,0
Minnesota,1992,136,32.5,0.0,88.0,136,0
Minnesota,1993,139,30.712230215827336,0.0,87.0,140,1
Minnesota,1994,144,28.96527777777778,0.0,83.0,144,0
Minnesota,1995,179,30.452513966480446,0.0,86.0,180,1
Minnesota,1996,162,30.055555555555557,0.0,81.0,162,0
Minnesota,1997,126,30.873015873015873,0.0,91.0,127,1
Minnesota,1998,117,28.46153846153846,0.0,84.0,117,0
Minnesota,1999,128,31.515625,0.0,92.0,131,3
Minnesota,2000,111,33.873873873873876,2.0,93.0,113,2
Minnesota,2001,120,32.15,0.0,89.0,120,0
Minnesota,2002,116,28.56896551724138,0.0,88.0,116,0
Minnesota,2003,124,32.435483870967744,0.0,90.0,126,2
Minnesota,2004,121,30.140495867768596,0.0,66.0,121,0
Minnesota,2005,119,35.294117647058826,0.0,82.0,120,1
Minnesota,2006,124,28.79032258064516,0.0,79.0,124,0
Minnesota,2007,110,30.2,0.0,81.0,111,1
Minnesota,2008,118,33.17796610169491,0.0,90.0,118,0
Minnesota,2009,89,28.876404494382022,0.0,69.0,89,0
Minnesota,2010,105,29.895238095238096,0.0,83.0,105,0
Minnesota,2011,82,31.646341463414632,0.0,68.0,82,0
Minnesota,2012,116,33.6551724137931,0.0,83.0,116,0
Minnesota,2013,127,34.52755905511811,0.0,98.0,127,0
Minnesota,2014,110,31.727272727272727,0.0,86.0,110,0
Minnesota,2015,145,34.55172413793103,0.0,90.0,146,1
Minnesota,2016,120,33.55833333333333,0.0,95.0,122,2
Minnesota,2017,129,34.51937984496124,0.0,79.0,129,0
Minnesota,2018,126,33.404761904761905,0.0,97.0,127,1
Minnesota,2019,144,33.020833333333336,0.0,77.0,144,0
Minnesota,2020,226,32.15486725663717,0.0,82.0,230,4
Minnesota,2021,268,34.97014925373134,0.0,92.0,274,6
Mississippi,1976,183,35.5792349726776,0.0,86.0,187,4
Mississippi,1977,204,34.18627450980392,0.0,83.0,219,15
Mississippi,1978,206,34.54368932038835,0.0,80.0,209,3
Mississippi,1979,205,35.50243902439024,16.0,80.0,207,2
Mississippi,1980,215,34.35813953488372,1.0,79.0,218,3
Mississippi,1981,239,36.58995815899581,0.0,99.0,246,7
Mississippi,1982,230,36.78260869565217,0.0,89.0,232,2
Mississippi,1983,197,36.15228426395939,0.0,83.0,198,1
Mississippi,1984,161,35.67701863354037,0.0,81.0,165,4
Mississippi,1985,177,34.06214689265537,0.0,88.0,180,3
Mississippi,1986,165,35.593939393939394,0.0,99.0,170,5
Mississippi,1987,175,35.142857142857146,0.0,81.0,178,3
Mississippi,1988,148,35.66891891891892,0.0,90.0,152,4
Mississippi,1989,164,35.63414634146341,0.0,84.0,169,5
Mississippi,1990,173,35.13294797687861,0.0,87.0,178,5
Mississippi,1991,216,33.513888888888886,0.0,88.0,219,3
Mississippi,1992,203,32.70935960591133,0.0,97.0,209,6
Mississippi,1993,231,34.74458874458875,0.0,85.0,234,3
Mississippi,1994,225,32.60888888888889,0.0,89.0,232,7
Mississippi,1995,194,32.077319587628864,0.0,95.0,201,7
Mississippi,1996,182,32.956043956043956,0.0,87.0,190,8
Mississippi,1997,190,31.405263157894737,0.0,79.0,193,3
Mississippi,1998,180,36.13333333333333,0.0,93.0,185,5
Mississippi,1999,145,31.517241379310345,0.0,77.0,151,6
Mississippi,2000,167,31.664670658682635,0.0,78.0,174,7
Mississippi,2001,187,32.9572192513369,0.0,87.0,193,6
Mississippi,2002,183,35.005464480874316,0.0,85.0,194,11
Mississippi,2003,187,38.283422459893046,0.0,87.0,191,4
Mississippi,2004,178,33.40449438202247,0.0,92.0,181,3
Mississippi,2005,163,36.079754601226995,0.0,93.0,164,1
Mississippi,2006,175,35.92,0.0,99.0,180,5
Mississippi,2007,152,33.10526315789474,0.0,81.0,154,2
Mississippi,2008,190,33.310526315789474,0.0,93.0,192,2
Mississippi,2009,158,36.14556962025316,0.0,88.0,162,4
Mississippi,2010,172,35.43023255813954,2.0,86.0,174,2
Mississippi,2011,193,34.93782383419689,0.0,91.0,195,2
Mississippi,2012,177,37.41242937853107,1.0,89.0,179,2
Mississippi,2013,145,35.08965517241379,0.0,80.0,147,2
Mississippi,2014,172,33.73837209302326,0.0,91.0,173,1
Mississippi,2015,156,37.19230769230769,0.0,93.0,160,4
Mississippi,2016,156,34.62179487179487,1.0,85.0,157,1
Mississippi,2017,157,34.88535031847134,3.0,78.0,162,5
Mississippi,2018,155,33.94838709677419,0.0,84.0,157,2
Mississippi,2019,202,33.193069306930695,0.0,80.0,204,2
Mississippi,2020,223,33.20627802690583,0.0,73.0,237,14
Mississippi,2021,171,34.251461988304094,0.0,86.0,173,2
Missouri,1976,414,33.97826086956522,0.0,94.0,421,7
Missouri,1977,459,32.928104575163395,0.0,86.0,459,0
Missouri,1978,456,33.50219298245614,0.0,97.0,458,2
Missouri,1979,487,33.06981519507187,0.0,99.0,504,17
Missouri,1980,526,33.756653992395435,0.0,95.0,531,5
Missouri,1981,501,34.17964071856287,0.0,99.0,511,10
Missouri,1982,461,33.14533622559653,0.0,89.0,465,4
Missouri,1983,386,34.37823834196891,0.0,93.0,388,2
Missouri,1984,341,33.67448680351906,0.0,88.0,344,3
Missouri,1985,383,34.10443864229765,0.0,89.0,387,4
Missouri,1986,441,33.50566893424036,0.0,89.0,447,6
Missouri,1987,389,34.087403598971726,0.0,90.0,395,6
Missouri,1988,384,33.752604166666664,0.0,99.0,394,10
Missouri,1989,407,30.97788697788698,0.0,93.0,413,6
Missouri,1990,432,31.74074074074074,0.0,90.0,438,6
Missouri,1991,516,31.118217054263567,0.0,92.0,523,7
Missouri,1992,512,30.49609375,0.0,95.0,519,7
Missouri,1993,558,29.982078853046595,0.0,89.0,560,2
Missouri,1994,548,30.843065693430656,0.0,94.0,554,6
Missouri,1995,449,31.7728285077951,0.0,99.0,455,6
Missouri,1996,397,32.1712846347607,0.0,97.0,407,10
Missouri,1997,399,32.37593984962406,0.0,90.0,402,3
Missouri,1998,385,31.45194805194805,0.0,90.0,387,2
Missouri,1999,341,30.923753665689148,0.0,84.0,341,0
Missouri,2000,341,30.741935483870968,0.0,81.0,343,2
Missouri,2001,393,30.59287531806616,0.0,89.0,396,3
Missouri,2002,351,31.042735042735043,0.0,90.0,352,1
Missouri,2003,321,31.853582554517136,0.0,86.0,323,2
Missouri,2004,374,33.25133689839572,0.0,94.0,377,3
Missouri,2005,425,32.07058823529412,0.0,87.0,425,0
Missouri,2006,354,32.324858757062145,0.0,90.0,356,2
Missouri,2007,399,32.1328320802005,0.0,89.0,401,2
Missouri,2008,491,33.568228105906314,0.0,85.0,493,2
Missouri,2009,421,29.63895486935867,0.0,91.0,422,1
Missouri,2010,447,32.407158836689035,0.0,98.0,450,3
Missouri,2011,402,32.78606965174129,0.0,93.0,402,0
Missouri,2012,421,30.700712589073635,0.0,92.0,423,2
Missouri,2013,401,33.70324189526185,0.0,95.0,405,4
Missouri,2014,435,33.195402298850574,0.0,91.0,439,4
Missouri,2015,537,32.76908752327747,0.0,92.0,538,1
Missouri,2016,575,33.893913043478264,0.0,87.0,579,4
Missouri,2017,653,33.59724349157734,0.0,94.0,659,6
Missouri,2018,607,34.494233937397034,0.0,86.0,609,2
Missouri,2019,626,33.456869009584665,0.0,91.0,628,2
Missouri,2020,606,33.03300330033003,0.0,99.0,619,13
Missouri,2021,636,34.020440251572325,0.0,99.0,639,3
Montana,1976,27,40.074074074074076,0.0,93.0,27,0
Montana,1977,30,31.366666666666667,0.0,67.0,30,0
Montana,1978,36,36.80555555555556,1.0,82.0,36,0
Montana,1979,33,29.96969696969697,1.0,72.0,33,0
Montana,1980,29,30.379310344827587,0.0,63.0,29,0
Montana,1981,23,38.56521739130435,6.0,77.0,23,0
Montana,1982,1,29.0,29.0,29.0,1,0
Montana,1983,23,35.56521739130435,1.0,85.0,23,0
Montana,1984,32,36.3125,2.0,68.0,32,0
Montana,1985,30,33.4,0.0,76.0,30,0
Montana,1986,2,30.5,25.0,36.0,2,0
Montana,1988,19,32.05263157894737,2.0,75.0,19,0
Montana,1989,22,31.363636363636363,4.0,51.0,22,0
Montana,1990,1,27.0,27.0,27.0,1,0
Montana,1991,16,42.0,23.0,89.0,18,2
Montana,1992,19,35.73684210526316,16.0,55.0,20,1
Montana,1995,19,35.526315789473685,0.0,79.0,19,0
Montana,1997,16,36.8125,18.0,66.0,16,0
Montana,1998,10,41.7,0.0,79.0,11,1
Montana,1999,11,33.54545454545455,14.0,57.0,11,0
Montana,2000,12,32.083333333333336,19.0,68.0,12,0
Montana,2001,21,28.523809523809526,1.0,81.0,22,1
Montana,2002,13,34.61538461538461,1.0,90.0,13,0
Montana,2003,22,29.545454545454547,1.0,58.0,22,0
Montana,2004,29,31.0,1.0,75.0,29,0
Montana,2005,23,35.73913043478261,17.0,73.0,23,0
Montana,2006,21,44.42857142857143,0.0,70.0,21,0
Montana,2007,15,32.2,13.0,60.0,15,0
Montana,2008,25,32.12,0.0,67.0,28,3
Montana,2009,27,37.03703703703704,0.0,84.0,28,1
Montana,2010,23,40.34782608695652,3.0,81.0,23,0
Montana,2011,16,39.0,1.0,63.0,19,3
Montana,2012,23,42.0,3.0,69.0,23,0
Montana,2013,16,40.75,3.0,77.0,16,0
Montana,2014,29,33.827586206896555,0.0,72.0,30,1
Montana,2015,37,37.891891891891895,1.0,79.0,38,1
Montana,2016,36,38.47222222222222,0.0,82.0,37,1
Montana,2017,43,38.46511627906977,0.0,80.0,43,0
Montana,2018,40,39.25,0.0,81.0,40,0
Montana,2019,37,38.86486486486486,0.0,78.0,37,0
Montana,2020,69,31.55072463768116,0.0,65.0,69,0
Montana,2021,39,39.97435897435897,0.0,79.0,39,0
Nebraska,1976,44,27.727272727272727,0.0,79.0,44,0
Nebraska,1977,51,33.549019607843135,0.0,97.0,51,0
Nebraska,1978,36,32.638888888888886,0.0,76.0,36,0
Nebraska,1979,64,33.796875,0.0,72.0,64,0
Nebraska,1980,58,28.603448275862068,0.0,79.0,58,0
Nebraska,1981,57,31.912280701754387,0.0,87.0,57,0
Nebraska,1982,35,30.885714285714286,1.0,84.0,35,0
Nebraska,1983,44,32.86363636363637,0.0,81.0,44,0
Nebraska,1984,54,33.75925925925926,0.0,83.0,54,0
Nebraska,1985,46,37.26086956521739,1.0,85.0,46,0
Nebraska,1986,54,26.5,0.0,75.0,55,1
Nebraska,1987,25,31.68,0.0,73.0,25,0
Nebraska,1988,58,29.67241379310345,0.0,83.0,58,0
Nebraska,1989,39,31.205128205128204,0.0,87.0,40,1
Nebraska,1990,42,33.333333333333336,1.0,80.0,42,0
Nebraska,1991,55,30.527272727272727,0.0,73.0,56,1
Nebraska,1992,44,34.02272727272727,3.0,84.0,44,0
Nebraska,1993,31,28.870967741935484,0.0,58.0,31,0
Nebraska,1994,19,34.73684210526316,0.0,74.0,19,0
Nebraska,1995,21,28.80952380952381,0.0,51.0,21,0
Nebraska,1996,21,22.61904761904762,1.0,66.0,21,0
Nebraska,1997,22,28.545454545454547,0.0,57.0,22,0
Nebraska,1998,25,34.4,1.0,74.0,25,0
Nebraska,1999,26,38.69230769230769,0.0,86.0,26,0
Nebraska,2000,29,35.86206896551724,8.0,83.0,29,0
Nebraska,2001,18,38.05555555555556,0.0,99.0,19,1
Nebraska,2002,23,33.08695652173913,0.0,61.0,23,0
Nebraska,2003,21,37.333333333333336,2.0,68.0,21,0
Nebraska,2004,27,33.22222222222222,1.0,73.0,30,3
Nebraska,2005,15,25.266666666666666,0.0,46.0,15,0
Nebraska,2006,16,34.6875,0.0,75.0,17,1
Nebraska,2007,23,32.73913043478261,0.0,75.0,23,0
Nebraska,2008,23,36.82608695652174,0.0,72.0,23,0
Nebraska,2009,47,30.680851063829788,0.0,82.0,47,0
Nebraska,2010,58,28.82758620689655,1.0,63.0,58,0
Nebraska,2011,71,31.380281690140844,0.0,73.0,71,0
Nebraska,2012,56,29.089285714285715,1.0,64.0,56,0
Nebraska,2013,64,35.515625,0.0,93.0,64,0
Nebraska,2014,57,33.68421052631579,1.0,76.0,57,0
Nebraska,2015,63,32.34920634920635,2.0,64.0,63,0
Nebraska,2016,43,39.81395348837209,1.0,87.0,43,0
Nebraska,2017,47,36.765957446808514,0.0,99.0,47,0
Nebraska,2018,44,33.68181818181818,0.0,79.0,45,1
Nebraska,2019,52,33.46153846153846,0.0,71.0,52,0
Nebraska,2020,67,33.44776119402985,15.0,72.0,67,0
Nebraska,2021,47,32.787234042553195,0.0,78.0,47,0
Nevada,1976,78,33.666666666666664,0.0,75.0,78,0
Nevada,1977,83,33.54216867469879,1.0,79.0,83,0
Nevada,1978,92,37.58695652173913,0.0,82.0,93,1
Nevada,1979,119,33.42857142857143,0.0,79.0,125,6
Nevada,1980,151,36.42384105960265,2.0,90.0,154,3
Nevada,1981,157,37.71974522292994,9.0,88.0,159,2
Nevada,1982,127,36.63779527559055,4.0,80.0,130,3
Nevada,1983,117,35.17948717948718,0.0,79.0,118,1
Nevada,1984,97,35.0,0.0,79.0,97,0
Nevada,1985,101,37.366336633663366,1.0,82.0,101,0
Nevada,1986,105,35.647619047619045,1.0,89.0,110,5
Nevada,1987,78,37.30769230769231,1.0,83.0,82,4
Nevada,1988,103,36.29126213592233,0.0,89.0,104,1
Nevada,1989,98,35.03061224489796,12.0,83.0,98,0
Nevada,1990,105,32.647619047619045,0.0,68.0,105,0
Nevada,1991,138,32.93478260869565,0.0,91.0,139,1
Nevada,1992,135,35.79259259259259,0.0,79.0,136,1
Nevada,1993,134,33.02985074626866,0.0,92.0,137,3
Nevada,1994,174,32.88505747126437,0.0,81.0,176,2
Nevada,1995,172,32.88953488372093,0.0,86.0,174,2
Nevada,1996,215,31.246511627906976,0.0,77.0,227,12
Nevada,1997,193,34.0880829015544,0.0,95.0,196,3
Nevada,1998,180,30.994444444444444,0.0,86.0,184,4
Nevada,1999,170,36.917647058823526,0.0,86.0,174,4
Nevada,2000,134,31.992537313432837,0.0,79.0,135,1
Nevada,2001,190,34.60526315789474,0.0,88.0,197,7
Nevada,2002,189,33.25925925925926,0.0,87.0,191,2
Nevada,2003,195,34.59487179487179,0.0,86.0,202,7
Nevada,2004,179,33.11731843575419,0.0,86.0,187,8
Nevada,2005,221,31.660633484162897,0.0,91.0,225,4
Nevada,2006,239,33.47698744769875,0.0,83.0,242,3
Nevada,2007,205,32.20975609756098,0.0,80.0,208,3
Nevada,2008,180,33.51111111111111,0.0,86.0,183,3
Nevada,2009,182,33.74175824175824,0.0,84.0,183,1
Nevada,2010,173,35.54913294797688,0.0,95.0,175,2
Nevada,2011,154,32.83116883116883,0.0,79.0,155,1
Nevada,2012,134,36.582089552238806,0.0,87.0,136,2
Nevada,2013,168,36.57738095238095,0.0,84.0,168,0
Nevada,2014,185,36.37837837837838,0.0,97.0,185,0
Nevada,2015,202,38.12376237623762,0.0,87.0,203,1
Nevada,2016,226,34.482300884955755,0.0,92.0,228,2
Nevada,2017,306,35.467320261437905,0.0,82.0,311,5
Nevada,2018,235,34.685106382978724,0.0,84.0,239,4
Nevada,2019,178,38.061797752808985,0.0,90.0,179,1
Nevada,2020,204,36.318627450980394,0.0,92.0,206,2
Nevada,2021,238,36.69747899159664,1.0,85.0,243,5
New Hampshire,1976,18,34.333333333333336,1.0,97.0,18,0
New Hampshire,1977,26,39.5,3.0,76.0,26,0
New Hampshire,1978,12,22.75,2.0,55.0,12,0
New Hampshire,1979,21,38.0,1.0,82.0,21,0
New Hampshire,1980,24,36.458333333333336,14.0,81.0,24,0
New Hampshire,1981,28,31.964285714285715,0.0,81.0,28,0
New Hampshire,1982,21,28.238095238095237,0.0,76.0,21,0
New Hampshire,1983,19,33.73684210526316,0.0,77.0,19,0
New Hampshire,1984,12,27.0,1.0,56.0,12,0
New Hampshire,1985,18,34.611111111111114,10.0,79.0,18,0
New Hampshire,1986,23,29.782608695652176,0.0,59.0,24,1
New Hampshire,1987,34,31.970588235294116,4.0,86.0,34,0
New Hampshire,1988,29,37.93103448275862,0.0,79.0,29,0
New Hampshire,1989,36,29.055555555555557,0.0,74.0,36,0
New Hampshire,1990,21,32.857142857142854,0.0,73.0,21,0
New Hampshire,1991,37,30.783783783783782,0.0,72.0,37,0
New Hampshire,1992,19,37.36842105263158,19.0,65.0,19,0
New Hampshire,1993,21,37.904761904761905,2.0,71.0,21,0
New Hampshire,1994,16,39.5625,1.0,57.0,16,0
New Hampshire,1995,16,39.625,0.0,88.0,17,1
New Hampshire,1996,21,37.857142857142854,6.0,87.0,21,0
New Hampshire,1998,16,39.9375,14.0,91.0,16,0
New Hampshire,1999,20,32.05,0.0,77.0,20,0
New Hampshire,2000,15,35.733333333333334,0.0,73.0,15,0
New Hampshire,2001,19,42.473684210526315,0.0,82.0,19,0
New Hampshire,2002,14,31.714285714285715,19.0,62.0,14,0
New Hampshire,2003,11,45.09090909090909,26.0,80.0,11,0
New Hampshire,2004,13,36.76923076923077,2.0,80.0,14,1
New Hampshire,2005,18,35.55555555555556,0.0,91.0,18,0
New Hampshire,2006,12,32.25,1.0,49.0,12,0
New Hampshire,2007,11,36.90909090909091,18.0,64.0,11,0
New Hampshire,2008,13,42.76923076923077,21.0,68.0,13,0
New Hampshire,2009,10,34.3,0.0,73.0,11,1
New Hampshire,2010,13,36.46153846153846,4.0,67.0,13,0
New Hampshire,2011,16,32.3125,3.0,69.0,17,1
New Hampshire,2012,15,42.6,19.0,85.0,15,0
New Hampshire,2013,22,39.86363636363637,2.0,83.0,23,1
New Hampshire,2014,16,44.625,3.0,71.0,16,0
New Hampshire,2015,15,45.4,6.0,75.0,15,0
New Hampshire,2016,20,41.1,2.0,82.0,20,0
New Hampshire,2017,18,39.44444444444444,2.0,76.0,18,0
New Hampshire,2018,24,38.333333333333336,1.0,69.0,24,0
New Hampshire,2019,43,48.30232558139535,0.0,90.0,43,0
New Hampshire,2020,24,38.583333333333336,0.0,81.0,24,0
New Hampshire,2021,23,41.869565217391305,12.0,80.0,23,0
New Jersey,1976,387,33.89664082687339,0.0,90.0,392,5
New Jersey,1977,427,33.33489461358314,0.0,89.0,431,4
New Jersey,1978,397,33.43073047858942,0.0,86.0,402,5
New Jersey,1979,474,33.280590717299575,0.0,90.0,490,16
New Jersey,1980,525,33.44190476190476,0.0,86.0,534,9
New Jersey,1981,552,34.875,0.0,94.0,567,15
New Jersey,1982,487,33.2135523613963,0.0,93.0,497,10
New Jersey,1983,412,34.39320388349515,0.0,97.0,415,3
New Jersey,1984,392,35.50765306122449,0.0,89.0,399,7
New Jersey,1985,403,33.977667493796524,0.0,86.0,419,16
New Jersey,1986,391,33.31713554987212,0.0,90.0,407,16
New Jersey,1987,358,34.89385474860335,0.0,92.0,365,7
New Jersey,1988,420,32.68571428571428,0.0,89.0,434,14
New Jersey,1989,397,31.596977329974813,0.0,85.0,406,9
New Jersey,1990,437,32.31578947368421,0.0,85.0,443,6
New Jersey,1991,417,34.77218225419664,0.0,92.0,421,4
New Jersey,1992,415,32.920481927710846,0.0,90.0,417,2
New Jersey,1993,428,32.245327102803735,0.0,94.0,433,5
New Jersey,1994,411,30.68126520681265,0.0,92.0,414,3
New Jersey,1995,418,31.29904306220096,0.0,89.0,423,5
New Jersey,1996,349,31.550143266475644,0.0,90.0,352,3
New Jersey,1997,356,28.764044943820224,0.0,85.0,358,2
New Jersey,1998,317,32.76656151419559,0.0,91.0,334,17
New Jersey,1999,293,32.55631399317406,0.0,91.0,296,3
New Jersey,2000,296,32.097972972972975,0.0,92.0,298,2
New Jersey,2001,350,33.25714285714286,0.0,89.0,355,5
New Jersey,2002,342,32.590643274853804,0.0,91.0,349,7
New Jersey,2003,418,31.904306220095695,0.0,79.0,421,3
New Jersey,2004,414,32.84541062801932,0.0,91.0,418,4
New Jersey,2005,433,31.695150115473442,0.0,91.0,434,1
New Jersey,2006,447,30.572706935123044,0.0,91.0,447,0
New Jersey,2007,390,30.05128205128205,0.0,85.0,390,0
New Jersey,2008,388,31.783505154639176,0.0,92.0,391,3
New Jersey,2009,334,31.67365269461078,0.0,96.0,334,0
New Jersey,2010,392,31.301020408163264,0.0,91.0,392,0
New Jersey,2011,397,31.75314861460957,0.0,93.0,398,1
New Jersey,2012,404,32.78465346534654,0.0,92.0,405,1
New Jersey,2013,418,32.23684210526316,0.0,81.0,420,2
New Jersey,2014,358,32.3463687150838,0.0,94.0,359,1
New Jersey,2015,372,34.026881720430104,0.0,88.0,372,0
New Jersey,2016,395,32.85316455696203,0.0,98.0,395,0
New Jersey,2017,346,34.07225433526011,0.0,85.0,346,0
New Jersey,2018,300,33.72666666666667,0.0,87.0,300,0
New Jersey,2019,273,33.84981684981685,0.0,86.0,277,4
New Jersey,2020,331,33.82477341389728,2.0,89.0,336,5
New Jersey,2021,142,32.563380281690144,1.0,81.0,142,0
New Mexico,1976,114,31.19298245614035,0.0,71.0,115,1
New Mexico,1977,87,32.229885057471265,0.0,68.0,91,4
New Mexico,1978,83,34.45783132530121,2.0,86.0,87,4
New Mexico,1979,115,34.99130434782609,0.0,79.0,125,10
New Mexico,1980,134,30.29850746268657,1.0,85.0,141,7
New Mexico,1981,4,28.25,22.0,38.0,4,0
New Mexico,1982,113,33.7787610619469,0.0,77.0,115,2
New Mexico,1983,81,31.88888888888889,0.0,71.0,81,0
New Mexico,1984,78,33.23076923076923,0.0,89.0,79,1
New Mexico,1985,136,33.169117647058826,0.0,81.0,138,2
New Mexico,1986,143,33.18881118881119,0.0,93.0,145,2
New Mexico,1987,130,33.59230769230769,0.0,79.0,131,1
New Mexico,1988,132,35.42424242424242,0.0,82.0,134,2
New Mexico,1989,102,34.23529411764706,0.0,86.0,108,6
New Mexico,1990,92,33.43478260869565,0.0,84.0,96,4
New Mexico,1991,114,33.28947368421053,0.0,84.0,115,1
New Mexico,1992,101,33.801980198019805,1.0,84.0,101,0
New Mexico,1993,101,30.11881188118812,0.0,68.0,102,1
New Mexico,1994,115,35.29565217391304,1.0,85.0,115,0
New Mexico,1995,116,30.551724137931036,0.0,67.0,120,4
New Mexico,1996,144,31.97222222222222,0.0,89.0,144,0
New Mexico,1997,111,32.333333333333336,1.0,72.0,114,3
New Mexico,1998,156,32.44871794871795,0.0,72.0,157,1
New Mexico,1999,146,31.80821917808219,0.0,92.0,147,1
New Mexico,2000,125,33.16,0.0,87.0,126,1
New Mexico,2001,96,33.375,0.0,90.0,98,2
New Mexico,2002,148,34.99324324324324,1.0,89.0,149,1
New Mexico,2003,110,34.3,2.0,84.0,113,3
New Mexico,2004,154,34.298701298701296,0.0,80.0,158,4
New Mexico,2005,136,35.044117647058826,0.0,81.0,139,3
New Mexico,2006,110,31.01818181818182,0.0,86.0,111,1
New Mexico,2007,162,33.08024691358025,0.0,85.0,164,2
New Mexico,2008,141,35.12056737588652,0.0,86.0,144,3
New Mexico,2009,154,33.12337662337662,0.0,75.0,156,2
New Mexico,2010,140,33.57857142857143,0.0,95.0,142,2
New Mexico,2011,131,36.13740458015267,0.0,83.0,132,1
New Mexico,2012,112,35.6875,0.0,94.0,112,0
New Mexico,2013,117,34.51282051282051,0.0,74.0,119,2
New Mexico,2014,127,31.968503937007874,0.0,90.0,128,1
New Mexico,2015,104,36.625,0.0,87.0,105,1
New Mexico,2016,110,36.345454545454544,0.0,99.0,111,1
New Mexico,2017,164,39.853658536585364,0.0,99.0,166,2
New Mexico,2018,167,36.61077844311377,0.0,76.0,168,1
New Mexico,2019,167,35.23353293413174,0.0,89.0,171,4
New Mexico,2020,150,37.00666666666667,0.0,99.0,154,4
New Mexico,2021,188,34.409574468085104,0.0,92.0,193,5
New York,1976,1104,34.32065217391305,0.0,99.0,1113,9
New York,1977,1997,34.43314972458688,0.0,93.0,2020,23
New York,1978,1877,33.733084709643045,0.0,91.0,1911,34
New York,1979,2134,34.18228678537957,0.0,97.0,2187,53
New York,1980,2153,34.13237343241988,0.0,95.0,2197,44
New York,1981,1781,33.597417181358786,0.0,92.0,1818,37
New York,1982,1968,33.84806910569106,0.0,96.0,1992,24
New York,1983,2037,32.48208149239077,0.0,92.0,2086,49
New York,1984,1742,32.97703788748565,0.0,95.0,1829,87
New York,1985,1492,32.86528150134048,0.0,96.0,1562,70
New York,1986,1595,32.10031347962382,0.0,94.0,1682,87
New York,1987,1855,31.390296495956875,0.0,88.0,1881,26
New York,1988,2141,30.741242410088745,0.0,96.0,2143,2
New York,1989,1960,30.866326530612245,0.0,94.0,1963,3
New York,1990,2230,30.72645739910314,0.0,92.0,2268,38
New York,1991,2362,30.83065198983912,0.0,96.0,2411,49
New York,1992,2397,30.77555277430121,0.0,91.0,2447,50
New York,1993,2451,30.57201142390861,0.0,92.0,2511,60
New York,1994,1998,30.685685685685687,0.0,91.0,2062,64
New York,1995,1532,31.7088772845953,0.0,93.0,1601,69
New York,1996,1327,31.526752072343633,0.0,90.0,1355,28
New York,1997,1094,32.13254113345521,0.0,94.0,1113,19
New York,1998,915,31.662295081967212,0.0,94.0,931,16
New York,1999,909,32.34653465346535,0.0,96.0,925,16
New York,2000,940,31.554255319148936,0.0,93.0,956,16
New York,2001,929,31.638320775026912,0.0,91.0,949,20
New York,2002,879,31.47212741751991,0.0,95.0,903,24
New York,2003,902,31.33148558758315,0.0,95.0,917,15
New York,2004,887,32.32807215332582,0.0,95.0,902,15
New York,2005,879,31.646188850967008,0.0,89.0,894,15
New York,2006,933,32.09967845659164,0.0,93.0,944,11
New York,2007,786,31.40203562340967,0.0,86.0,800,14
New York,2008,835,31.8311377245509,0.0,90.0,839,4
New York,2009,775,32.69032258064516,0.0,92.0,781,6
New York,2010,854,30.72365339578454,0.0,89.0,863,9
New York,2011,761,33.1419185282523,0.0,98.0,769,8
New York,2012,680,30.935294117647057,0.0,90.0,682,2
New York,2013,644,34.75931677018634,0.0,99.0,651,7
New York,2014,641,33.89079563182527,0.0,97.0,642,1
New York,2015,644,32.99223602484472,0.0,96.0,644,0
New York,2016,669,33.440956651718984,0.0,85.0,669,0
New York,2017,560,34.79107142857143,0.0,95.0,564,4
New York,2018,554,34.514440433213,0.0,99.0,562,8
New York,2019,573,33.57766143106457,0.0,94.0,577,4
New York,2020,817,34.06854345165239,0.0,99.0,820,3
New York,2021,894,34.35011185682327,0.0,99.0,899,5
North Carolina,1976,596,35.82382550335571,0.0,85.0,607,11
North Carolina,1977,604,34.567880794701985,0.0,90.0,615,11
North Carolina,1978,587,35.45826235093697,0.0,88.0,604,17
North Carolina,1979,590,35.14745762711864,0.0,84.0,599,9
North Carolina,1980,611,35.69230769230769,0.0,91.0,628,17
North Carolina,1981,530,36.99245283018868,0.0,99.0,541,11
North Carolina,1982,560,35.566071428571426,0.0,89.0,563,3
North Carolina,1983,514,35.525291828793776,0.0,87.0,521,7
North Carolina,1984,485,35.61443298969072,0.0,92.0,495,10
North Carolina,1985,523,35.30210325047801,0.0,85.0,527,4
North Carolina,1986,514,34.340466926070036,0.0,90.0,519,5
North Carolina,1987,511,34.58708414872798,0.0,94.0,523,12
North Carolina,1988,499,34.75751503006012,0.0,82.0,507,8
North Carolina,1989,582,36.223367697594504,0.0,93.0,589,7
North Carolina,1990,690,34.073913043478264,0.0,91.0,704,14
North Carolina,1991,753,32.82602921646746,0.0,92.0,779,26
North Carolina,1992,709,33.59379407616361,0.0,95.0,728,19
North Carolina,1993,780,32.75,0.0,99.0,796,16
North Carolina,1994,760,32.83552631578947,0.0,88.0,785,25
North Carolina,1995,681,33.46842878120411,0.0,95.0,714,33
North Carolina,1996,620,32.37741935483871,0.0,90.0,638,18
North Carolina,1997,613,34.91190864600326,0.0,99.0,647,34
North Carolina,1998,623,33.22792937399679,0.0,98.0,633,10
North Carolina,1999,552,33.630434782608695,0.0,85.0,575,23
North Carolina,2000,542,34.1309963099631,0.0,95.0,570,28
North Carolina,2001,517,33.802707930367504,0.0,91.0,543,26
North Carolina,2002,556,34.20503597122302,0.0,94.0,572,16
North Carolina,2003,491,32.17718940936864,0.0,86.0,521,30
North Carolina,2004,480,34.59583333333333,0.0,99.0,503,23
North Carolina,2005,564,33.49290780141844,0.0,87.0,593,29
North Carolina,2006,534,33.147940074906366,0.0,83.0,560,26
North Carolina,2007,549,34.91074681238616,0.0,99.0,575,26
North Carolina,2008,588,33.67006802721088,0.0,92.0,619,31
North Carolina,2009,486,34.61934156378601,0.0,98.0,506,20
North Carolina,2010,454,35.45374449339207,0.0,92.0,468,14
North Carolina,2011,491,33.765784114052956,0.0,93.0,507,16
North Carolina,2012,490,35.29183673469388,0.0,92.0,503,13
North Carolina,2013,455,34.276923076923076,0.0,88.0,477,22
North Carolina,2014,478,36.43933054393305,0.0,88.0,493,15
North Carolina,2015,511,34.183953033268104,0.0,93.0,525,14
North Carolina,2016,607,36.63097199341021,0.0,90.0,619,12
North Carolina,2017,588,34.29421768707483,0.0,90.0,601,13
North Carolina,2018,493,35.38742393509128,1.0,87.0,510,17
North Carolina,2019,556,34.052158273381295,0.0,88.0,564,8
North Carolina,2020,803,33.42465753424658,0.0,94.0,809,6
North Carolina,2021,1009,33.947472745292366,0.0,99.0,1020,11
North Dakota,1976,8,46.5,16.0,78.0,8,0
North Dakota,1977,3,18.666666666666668,3.0,29.0,3,0
North Dakota,1978,8,34.0,22.0,50.0,8,0
North Dakota,1979,11,30.90909090909091,2.0,86.0,11,0
North Dakota,1980,9,28.11111111111111,0.0,52.0,9,0
North Dakota,1981,15,34.0,0.0,83.0,15,0
North Dakota,1982,6,35.333333333333336,18.0,54.0,6,0
North Dakota,1983,15,36.8,6.0,54.0,15,0
North Dakota,1984,13,18.0,0.0,37.0,13,0
North Dakota,1985,7,48.142857142857146,21.0,75.0,7,0
North Dakota,1986,7,42.857142857142854,25.0,74.0,7,0
North Dakota,1987,10,26.4,2.0,56.0,10,0
North Dakota,1988,13,32.38461538461539,0.0,61.0,13,0
North Dakota,1989,3,38.666666666666664,25.0,52.0,3,0
North Dakota,1990,5,33.4,20.0,43.0,5,0
North Dakota,1991,4,45.25,24.0,69.0,4,0
North Dakota,1992,12,38.416666666666664,1.0,72.0,12,0
North Dakota,1993,10,26.4,0.0,46.0,11,1
North Dakota,1994,1,66.0,66.0,66.0,1,0
North Dakota,1995,5,44.0,27.0,74.0,5,0
North Dakota,1996,11,41.45454545454545,25.0,60.0,11,0
North Dakota,1997,7,53.0,33.0,88.0,7,0
North Dakota,1998,7,31.0,4.0,53.0,7,0
North Dakota,1999,6,29.166666666666668,18.0,44.0,7,1
North Dakota,2000,4,30.75,12.0,41.0,4,0
North Dakota,2001,8,35.75,1.0,64.0,9,1
North Dakota,2002,5,25.4,0.0,73.0,5,0
North Dakota,2003,8,29.375,16.0,48.0,8,0
North Dakota,2004,8,31.875,0.0,69.0,8,0
North Dakota,2005,11,39.81818181818182,0.0,83.0,11,0
North Dakota,2006,6,33.0,2.0,53.0,7,1
North Dakota,2007,12,29.083333333333332,1.0,70.0,13,1
North Dakota,2008,2,36.5,30.0,43.0,3,1
North Dakota,2009,7,44.42857142857143,19.0,74.0,9,2
North Dakota,2010,9,40.666666666666664,16.0,59.0,9,0
North Dakota,2011,14,33.785714285714285,1.0,75.0,14,0
North Dakota,2012,14,31.285714285714285,1.0,83.0,14,0
North Dakota,2013,11,33.09090909090909,0.0,62.0,11,0
North Dakota,2014,15,37.53333333333333,13.0,66.0,15,0
North Dakota,2015,17,31.41176470588235,0.0,70.0,17,0
North Dakota,2016,16,31.0625,22.0,61.0,16,0
North Dakota,2017,25,29.28,22.0,58.0,25,0
North Dakota,2018,31,31.483870967741936,0.0,91.0,33,2
North Dakota,2019,28,40.57142857142857,0.0,84.0,28,0
North Dakota,2020,37,36.054054054054056,1.0,63.0,37,0
North Dakota,2021,28,39.464285714285715,8.0,78.0,28,0
Ohio,1976,709,34.744710860366716,0.0,84.0,711,2
Ohio,1977,702,34.08404558404558,0.0,86.0,705,3
Ohio,1978,731,34.85499316005472,0.0,95.0,738,7
Ohio,1979,898,33.83518930957684,0.0,89.0,900,2
Ohio,1980,874,34.61212814645309,0.0,94.0,879,5
Ohio,1981,795,34.67044025157233,0.0,94.0,797,2
Ohio,1982,687,33.951965065502186,0.0,90.0,689,2
Ohio,1983,587,35.91993185689949,0.0,90.0,589,2
Ohio,1984,538,33.36245353159851,0.0,90.0,543,5
Ohio,1985,535,34.586915887850466,0.0,95.0,540,5
Ohio,1986,542,34.41143911439114,0.0,88.0,546,4
Ohio,1987,603,34.9485903814262,0.0,97.0,605,2
Ohio,1988,554,34.568592057761734,0.0,92.0,559,5
Ohio,1989,628,32.64331210191083,0.0,94.0,632,4
Ohio,1990,627,33.09090909090909,0.0,95.0,634,7
Ohio,1991,727,30.711141678129298,0.0,93.0,738,11
Ohio,1992,683,31.31918008784773,0.0,92.0,686,3
Ohio,1993,627,29.671451355661883,0.0,99.0,631,4
Ohio,1994,621,31.075684380032207,0.0,88.0,623,2
Ohio,1995,544,31.823529411764707,0.0,86.0,553,9
Ohio,1996,495,30.733333333333334,0.0,92.0,496,1
Ohio,1997,376,32.047872340425535,0.0,86.0,380,4
Ohio,1998,373,31.77479892761394,0.0,86.0,377,4
Ohio,1999,369,33.547425474254744,0.0,98.0,372,3
Ohio,2000,366,33.84426229508197,0.0,86.0,372,6
Ohio,2001,446,32.374439461883405,0.0,88.0,452,6
Ohio,2002,494,32.534412955465584,0.0,89.0,504,10
Ohio,2003,484,33.599173553719005,0.0,89.0,497,13
Ohio,2004,470,33.09574468085106,0.0,99.0,495,25
Ohio,2005,549,32.3551912568306,0.0,86.0,565,16
Ohio,2006,507,32.42011834319526,0.0,88.0,526,19
Ohio,2007,489,31.971370143149283,0.0,87.0,505,16
Ohio,2008,479,31.887265135699373,0.0,90.0,487,8
Ohio,2009,509,34.644400785854614,0.0,99.0,520,11
Ohio,2010,470,33.18936170212766,0.0,99.0,481,11
Ohio,2011,498,32.700803212851405,0.0,91.0,499,1
Ohio,2012,471,32.723991507430995,0.0,87.0,475,4
Ohio,2013,469,32.18123667377399,0.0,99.0,474,5
Ohio,2014,454,32.980176211453745,0.0,97.0,455,1
Ohio,2015,496,32.34475806451613,0.0,94.0,506,10
Ohio,2016,647,33.03400309119011,0.0,89.0,653,6
Ohio,2017,705,33.05106382978723,0.0,90.0,713,8
Ohio,2018,556,34.6636690647482,0.0,99.0,563,7
Ohio,2019,526,32.70912547528517,0.0,90.0,532,6
Ohio,2020,785,32.26369426751592,0.0,99.0,787,2
Ohio,2021,814,32.62162162162162,0.0,91.0,825,11
Oklahoma,1976,198,33.93434343434343,0.0,82.0,204,6
Oklahoma,1977,216,33.824074074074076,0.0,83.0,216,0
Oklahoma,1978,252,33.09920634920635,0.0,76.0,253,1
Oklahoma,1979,309,36.3915857605178,0.0,87.0,311,2
Oklahoma,1980,319,33.30407523510972,0.0,89.0,320,1
Oklahoma,1981,316,34.80696202531646,0.0,89.0,316,0
Oklahoma,1982,374,33.783422459893046,0.0,89.0,378,4
Oklahoma,1983,271,33.95571955719557,0.0,92.0,272,1
Oklahoma,1984,263,33.57794676806083,0.0,90.0,264,1
Oklahoma,1985,281,33.338078291814945,0.0,95.0,283,2
Oklahoma,1986,284,35.88732394366197,0.0,93.0,285,1
Oklahoma,1987,268,34.667910447761194,0.0,92.0,268,0
Oklahoma,1988,264,36.333333333333336,0.0,92.0,265,1
Oklahoma,1989,239,35.40167364016737,0.0,86.0,240,1
Oklahoma,1990,271,33.981549815498155,0.0,87.0,272,1
Oklahoma,1991,244,31.540983606557376,0.0,88.0,246,2
Oklahoma,1992,221,34.85067873303167,0.0,90.0,221,0
Oklahoma,1993,301,32.83056478405316,0.0,88.0,301,0
Oklahoma,1994,259,32.189189189189186,0.0,83.0,259,0
Oklahoma,1995,414,36.23671497584541,0.0,97.0,416,2
Oklahoma,1996,235,33.30212765957447,0.0,85.0,235,0
Oklahoma,1997,248,31.508064516129032,0.0,89.0,249,1
Oklahoma,1998,215,33.57209302325582,0.0,87.0,215,0
Oklahoma,1999,254,35.425196850393704,0.0,91.0,254,0
Oklahoma,2000,202,34.93069306930693,0.0,90.0,202,0
Oklahoma,2001,215,33.47441860465116,0.0,92.0,215,0
Oklahoma,2002,186,34.27956989247312,0.0,77.0,186,0
Oklahoma,2003,232,32.82327586206897,0.0,87.0,232,0
Oklahoma,2004,205,35.385365853658534,0.0,94.0,205,0
Oklahoma,2005,201,33.89054726368159,0.0,86.0,201,0
Oklahoma,2006,219,33.06392694063927,0.0,96.0,223,4
Oklahoma,2007,251,32.625498007968126,0.0,87.0,253,2
Oklahoma,2008,231,34.58008658008658,0.0,91.0,231,0
Oklahoma,2009,245,31.804081632653062,0.0,85.0,246,1
Oklahoma,2010,208,30.634615384615383,0.0,71.0,209,1
Oklahoma,2011,224,35.473214285714285,0.0,87.0,227,3
Oklahoma,2012,238,34.78151260504202,0.0,89.0,239,1
Oklahoma,2013,216,34.96296296296296,0.0,94.0,216,0
Oklahoma,2014,196,35.224489795918366,0.0,96.0,199,3
Oklahoma,2015,273,33.58974358974359,0.0,95.0,275,2
Oklahoma,2016,262,34.95038167938932,0.0,91.0,269,7
Oklahoma,2017,277,34.20216606498195,0.0,84.0,283,6
Oklahoma,2018,231,35.67965367965368,0.0,84.0,232,1
Oklahoma,2019,291,37.103092783505154,0.0,87.0,298,7
Oklahoma,2020,359,36.949860724233986,0.0,90.0,363,4
Oklahoma,2021,343,37.011661807580175,0.0,86.0,345,2
Oregan,1976,98,38.09183673469388,0.0,92.0,98,0
Oregan,1977,106,35.87735849056604,0.0,83.0,106,0
Oregan,1978,120,34.291666666666664,0.0,78.0,121,1
Oregan,1979,112,32.785714285714285,0.0,79.0,112,0
Oregan,1980,140,32.40714285714286,0.0,83.0,141,1
Oregan,1981,118,33.652542372881356,0.0,84.0,118,0
Oregan,1982,143,35.41258741258741,0.0,86.0,143,0
Oregan,1983,112,32.964285714285715,0.0,71.0,113,1
Oregan,1984,147,34.5578231292517,0.0,94.0,147,0
Oregan,1985,133,35.61654135338346,0.0,77.0,133,0
Oregan,1986,184,36.27717391304348,0.0,91.0,184,0
Oregan,1987,164,32.73780487804878,0.0,93.0,166,2
Oregan,1988,160,37.01875,0.0,88.0,161,1
Oregan,1989,148,34.0945945945946,0.0,87.0,148,0
Oregan,1990,124,32.354838709677416,0.0,81.0,125,1
Oregan,1991,161,32.24223602484472,0.0,85.0,163,2
Oregan,1992,162,33.15432098765432,0.0,86.0,163,1
Oregan,1993,153,34.908496732026144,0.0,99.0,154,1
Oregan,1994,177,35.42372881355932,0.0,95.0,178,1
Oregan,1995,146,29.91780821917808,0.0,84.0,146,0
Oregan,1996,139,32.07194244604317,0.0,89.0,139,0
Oregan,1997,113,32.849557522123895,0.0,83.0,113,0
Oregan,1998,138,34.81884057971015,0.0,94.0,140,2
Oregan,1999,95,32.28421052631579,1.0,73.0,95,0
Oregan,2000,71,33.57746478873239,0.0,79.0,71,0
Oregan,2001,101,36.524752475247524,0.0,95.0,102,1
Oregan,2002,76,32.56578947368421,1.0,79.0,76,0
Oregan,2003,78,34.756410256410255,0.0,87.0,78,0
Oregan,2004,105,33.666666666666664,0.0,83.0,105,0
Oregan,2005,96,36.979166666666664,0.0,89.0,97,1
Oregan,2006,105,34.75238095238095,0.0,89.0,107,2
Oregan,2007,82,36.52439024390244,0.0,82.0,82,0
Oregan,2008,90,36.1,0.0,86.0,92,2
Oregan,2009,98,36.48979591836735,0.0,93.0,98,0
Oregan,2010,93,37.03225806451613,0.0,88.0,93,0
Oregan,2011,92,34.92391304347826,0.0,92.0,92,0
Oregan,2012,94,38.41489361702128,1.0,83.0,97,3
Oregan,2013,85,37.07058823529412,0.0,83.0,85,0
Oregan,2014,83,38.87951807228916,0.0,79.0,84,1
Oregan,2015,83,44.24096385542169,1.0,92.0,85,2
Oregan,2016,111,41.2972972972973,0.0,93.0,111,0
Oregan,2017,128,37.546875,0.0,93.0,131,3
Oregan,2018,114,41.35964912280702,0.0,89.0,115,1
Oregan,2019,147,40.64625850340136,0.0,92.0,148,1
Oregan,2020,173,34.716763005780344,0.0,90.0,173,0
Oregan,2021,241,37.39004149377593,0.0,91.0,241,0
Pennsylvania,1976,737,34.0325644504749,0.0,94.0,739,2
Pennsylvania,1977,685,34.2992700729927,0.0,94.0,687,2
Pennsylvania,1978,760,34.03815789473684,0.0,87.0,760,0
Pennsylvania,1979,754,33.92307692307692,0.0,99.0,755,1
Pennsylvania,1980,843,33.76986951364176,0.0,94.0,844,1
Pennsylvania,1981,759,34.0,0.0,94.0,759,0
Pennsylvania,1982,703,34.90184921763869,0.0,94.0,704,1
Pennsylvania,1983,610,34.350819672131145,0.0,92.0,613,3
Pennsylvania,1984,560,33.598214285714285,0.0,93.0,561,1
Pennsylvania,1985,581,36.81239242685026,0.0,92.0,581,0
Pennsylvania,1986,559,34.94275491949911,0.0,97.0,560,1
Pennsylvania,1987,519,32.48940269749518,0.0,92.0,524,5
Pennsylvania,1988,570,32.62456140350877,0.0,90.0,572,2
Pennsylvania,1989,741,31.831309041835357,0.0,93.0,745,4
Pennsylvania,1990,781,31.732394366197184,0.0,88.0,784,3
Pennsylvania,1991,733,33.165075034106415,0.0,90.0,733,0
Pennsylvania,1992,768,31.311197916666668,0.0,90.0,772,4
Pennsylvania,1993,833,30.746698679471788,0.0,99.0,834,1
Pennsylvania,1994,734,31.837874659400544,0.0,86.0,734,0
Pennsylvania,1995,722,32.64265927977839,0.0,93.0,725,3
Pennsylvania,1996,703,30.559032716927454,0.0,89.0,703,0
Pennsylvania,1997,739,30.254397834912044,0.0,90.0,739,0
Pennsylvania,1998,628,31.269108280254777,0.0,91.0,628,0
Pennsylvania,1999,596,30.609060402684563,0.0,89.0,596,0
Pennsylvania,2000,604,30.46523178807947,0.0,91.0,604,0
Pennsylvania,2001,649,31.62095531587057,0.0,87.0,657,8
Pennsylvania,2002,620,31.54193548387097,0.0,86.0,625,5
Pennsylvania,2003,655,31.712977099236642,0.0,89.0,661,6
Pennsylvania,2004,691,31.900144717800288,0.0,86.0,696,5
Pennsylvania,2005,780,31.56282051282051,0.0,94.0,785,5
Pennsylvania,2006,782,30.474424552429667,0.0,83.0,790,8
Pennsylvania,2007,785,31.542675159235667,0.0,87.0,794,9
Pennsylvania,2008,741,32.7085020242915,0.0,91.0,749,8
Pennsylvania,2009,736,32.92527173913044,0.0,97.0,741,5
Pennsylvania,2010,691,32.26483357452967,0.0,90.0,699,8
Pennsylvania,2011,683,31.219619326500734,0.0,93.0,689,6
Pennsylvania,2012,765,32.1764705882353,0.0,95.0,766,1
Pennsylvania,2013,666,33.3948948948949,0.0,97.0,667,1
Pennsylvania,2014,643,33.14618973561431,0.0,92.0,646,3
Pennsylvania,2015,699,32.486409155937054,0.0,95.0,705,6
Pennsylvania,2016,721,33.19001386962552,0.0,95.0,734,13
Pennsylvania,2017,800,32.27375,0.0,91.0,809,9
Pennsylvania,2018,840,33.858333333333334,0.0,97.0,845,5
Pennsylvania,2019,581,32.68674698795181,0.0,97.0,584,3
Pennsylvania,2020,271,30.210332103321033,1.0,79.0,272,1
Pennsylvania,2021,568,32.019366197183096,0.0,89.0,569,1
Rhode Island,1976,24,30.916666666666668,9.0,73.0,24,0
Rhode Island,1977,33,30.363636363636363,0.0,82.0,33,0
Rhode Island,1978,36,33.52777777777778,0.0,61.0,36,0
Rhode Island,1979,31,29.93548387096774,9.0,58.0,31,0
Rhode Island,1980,43,35.93023255813954,0.0,86.0,43,0
Rhode Island,1981,41,34.02439024390244,3.0,74.0,42,1
Rhode Island,1982,36,33.77777777777778,17.0,85.0,36,0
Rhode Island,1983,32,29.4375,0.0,53.0,32,0
Rhode Island,1984,32,30.375,0.0,83.0,32,0
Rhode Island,1985,35,34.08571428571429,0.0,89.0,36,1
Rhode Island,1986,34,33.911764705882355,0.0,82.0,34,0
Rhode Island,1987,41,33.146341463414636,6.0,75.0,41,0
Rhode Island,1988,40,31.95,0.0,83.0,41,1
Rhode Island,1989,47,31.595744680851062,5.0,62.0,51,4
Rhode Island,1990,46,35.15217391304348,1.0,87.0,48,2
Rhode Island,1991,37,29.16216216216216,2.0,73.0,38,1
Rhode Island,1992,37,30.72972972972973,0.0,76.0,37,0
Rhode Island,1993,40,27.5,0.0,64.0,41,1
Rhode Island,1994,42,30.714285714285715,0.0,74.0,44,2
Rhode Island,1995,32,24.3125,0.0,53.0,32,0
Rhode Island,1996,25,29.16,0.0,75.0,25,0
Rhode Island,1997,27,30.037037037037038,0.0,79.0,27,0
Rhode Island,1998,25,26.4,0.0,43.0,25,0
Rhode Island,1999,36,30.13888888888889,2.0,73.0,36,0
Rhode Island,2000,45,27.08888888888889,0.0,50.0,45,0
Rhode Island,2001,35,34.114285714285714,2.0,94.0,40,5
Rhode Island,2002,39,32.05128205128205,12.0,76.0,41,2
Rhode Island,2003,24,32.333333333333336,14.0,81.0,25,1
Rhode Island,2004,30,34.8,3.0,79.0,30,0
Rhode Island,2005,33,34.09090909090909,3.0,93.0,34,1
Rhode Island,2006,28,35.107142857142854,0.0,95.0,28,0
Rhode Island,2007,19,33.578947368421055,17.0,76.0,19,0
Rhode Island,2008,31,33.61290322580645,16.0,63.0,31,0
Rhode Island,2009,32,28.84375,6.0,57.0,32,0
Rhode Island,2010,29,33.10344827586207,18.0,83.0,30,1
Rhode Island,2011,20,31.35,14.0,71.0,20,0
Rhode Island,2012,36,33.80555555555556,0.0,61.0,37,1
Rhode Island,2013,31,38.806451612903224,10.0,78.0,31,0
Rhode Island,2014,27,35.148148148148145,17.0,78.0,27,0
Rhode Island,2015,30,39.5,0.0,85.0,31,1
Rhode Island,2016,30,42.13333333333333,0.0,81.0,31,1
Rhode Island,2017,21,33.333333333333336,0.0,69.0,21,0
Rhode Island,2018,17,36.411764705882355,15.0,67.0,17,0
Rhode Island,2019,26,35.11538461538461,0.0,70.0,26,0
Rhode Island,2020,32,33.0,19.0,62.0,32,0
Rhode Island,2021,40,32.35,2.0,74.0,40,0
South Carolina,1976,339,36.18879056047198,0.0,85.0,344,5
South Carolina,1977,367,36.11716621253406,0.0,85.0,373,6
South Carolina,1978,353,36.63739376770538,0.0,93.0,355,2
South Carolina,1979,390,35.76923076923077,0.0,89.0,391,1
South Carolina,1980,364,36.78021978021978,1.0,85.0,367,3
South Carolina,1981,334,35.955089820359284,0.0,81.0,336,2
South Carolina,1982,368,36.02173913043478,0.0,82.0,368,0
South Carolina,1983,332,38.18072289156626,0.0,86.0,333,1
South Carolina,1984,319,37.10344827586207,0.0,93.0,319,0
South Carolina,1985,323,34.188854489164086,0.0,90.0,323,0
South Carolina,1986,322,33.28260869565217,0.0,96.0,322,0
South Carolina,1987,324,34.56481481481482,0.0,86.0,326,2
South Carolina,1988,345,34.426086956521736,0.0,94.0,345,0
South Carolina,1989,334,34.18562874251497,0.0,82.0,336,2
South Carolina,1990,422,36.31042654028436,0.0,99.0,422,0
South Carolina,1991,382,32.638743455497384,0.0,86.0,382,0
South Carolina,1992,370,34.33513513513513,0.0,98.0,371,1
South Carolina,1993,391,33.186700767263424,0.0,99.0,392,1
South Carolina,1994,364,33.395604395604394,0.0,91.0,364,0
South Carolina,1995,301,35.77408637873754,0.0,99.0,301,0
South Carolina,1996,346,35.0606936416185,0.0,86.0,346,0
South Carolina,1997,323,34.811145510835914,0.0,93.0,324,1
South Carolina,1998,308,34.36363636363637,0.0,85.0,310,2
South Carolina,1999,276,32.5,0.0,86.0,278,2
South Carolina,2000,285,32.217543859649126,0.0,76.0,288,3
South Carolina,2001,332,34.49096385542169,0.0,86.0,333,1
South Carolina,2002,306,34.3235294117647,0.0,93.0,311,5
South Carolina,2003,307,32.79478827361564,0.0,81.0,308,1
South Carolina,2004,293,34.184300341296925,0.0,93.0,293,0
South Carolina,2005,321,35.77258566978193,0.0,89.0,321,0
South Carolina,2006,373,34.21983914209115,0.0,89.0,373,0
South Carolina,2007,363,33.66942148760331,0.0,84.0,369,6
South Carolina,2008,309,35.323624595469255,0.0,90.0,318,9
South Carolina,2009,312,34.30448717948718,0.0,83.0,315,3
South Carolina,2010,277,35.94584837545126,0.0,91.0,278,1
South Carolina,2011,332,34.596385542168676,0.0,89.0,334,2
South Carolina,2012,347,36.35446685878963,0.0,87.0,349,2
South Carolina,2013,315,35.41269841269841,0.0,99.0,318,3
South Carolina,2014,333,34.51651651651652,0.0,92.0,336,3
South Carolina,2015,424,35.905660377358494,0.0,87.0,428,4
South Carolina,2016,381,36.24409448818898,0.0,82.0,387,6
South Carolina,2017,402,34.450248756218905,0.0,87.0,409,7
South Carolina,2018,410,33.08048780487805,0.0,82.0,417,7
South Carolina,2019,488,33.084016393442624,0.0,99.0,490,2
South Carolina,2020,571,32.8108581436077,0.0,93.0,575,4
South Carolina,2021,603,33.02985074626866,0.0,94.0,605,2
South Dakota,1976,10,30.7,0.0,78.0,10,0
South Dakota,1977,12,35.833333333333336,1.0,82.0,12,0
South Dakota,1978,9,35.888888888888886,0.0,74.0,9,0
South Dakota,1979,10,47.5,20.0,75.0,10,0
South Dakota,1980,5,26.8,15.0,44.0,5,0
South Dakota,1981,10,25.3,0.0,50.0,10,0
South Dakota,1982,16,30.375,3.0,53.0,16,0
South Dakota,1983,11,41.36363636363637,26.0,61.0,11,0
South Dakota,1984,10,37.1,25.0,65.0,10,0
South Dakota,1985,8,31.5,18.0,48.0,9,1
South Dakota,1986,18,36.27777777777778,9.0,92.0,18,0
South Dakota,1987,10,25.0,0.0,72.0,11,1
South Dakota,1988,13,27.53846153846154,0.0,80.0,13,0
South Dakota,1989,8,47.0,0.0,83.0,8,0
South Dakota,1990,14,28.5,0.0,85.0,14,0
South Dakota,1991,12,27.166666666666668,11.0,44.0,12,0
South Dakota,1992,6,41.166666666666664,22.0,80.0,6,0
South Dakota,1993,21,21.666666666666668,1.0,67.0,21,0
South Dakota,1994,9,29.555555555555557,4.0,60.0,9,0
South Dakota,1995,12,32.166666666666664,14.0,53.0,13,1
South Dakota,1996,6,27.5,0.0,67.0,6,0
South Dakota,1997,5,41.0,27.0,60.0,5,0
South Dakota,1998,6,35.0,16.0,74.0,6,0
South Dakota,1999,13,26.615384615384617,0.0,64.0,14,1
South Dakota,2000,7,17.571428571428573,0.0,41.0,8,1
South Dakota,2001,10,27.7,15.0,53.0,10,0
South Dakota,2002,12,33.5,1.0,59.0,12,0
South Dakota,2003,11,27.363636363636363,0.0,54.0,11,0
South Dakota,2004,16,39.375,18.0,80.0,16,0
South Dakota,2005,15,37.8,2.0,81.0,15,0
South Dakota,2006,11,39.27272727272727,0.0,55.0,11,0
South Dakota,2007,13,30.692307692307693,0.0,82.0,15,2
South Dakota,2008,22,44.72727272727273,1.0,85.0,24,2
South Dakota,2009,17,29.0,16.0,45.0,18,1
South Dakota,2010,17,31.352941176470587,0.0,65.0,17,0
South Dakota,2011,19,33.31578947368421,0.0,75.0,19,0
South Dakota,2012,12,33.0,1.0,73.0,16,4
South Dakota,2013,13,22.923076923076923,1.0,50.0,13,0
South Dakota,2014,20,39.4,0.0,74.0,20,0
South Dakota,2015,30,29.6,0.0,61.0,30,0
South Dakota,2016,24,35.291666666666664,0.0,77.0,24,0
South Dakota,2017,26,31.346153846153847,0.0,64.0,26,0
South Dakota,2018,23,30.782608695652176,1.0,77.0,23,0
South Dakota,2019,34,36.05882352941177,0.0,79.0,34,0
South Dakota,2020,65,30.446153846153845,0.0,71.0,65,0
South Dakota,2021,46,42.130434782608695,0.0,91.0,46,0
Tennessee,1976,370,35.73243243243243,3.0,86.0,377,7
Tennessee,1977,312,35.8974358974359,0.0,83.0,314,2
Tennessee,1978,406,35.960591133004925,0.0,87.0,410,4
Tennessee,1979,432,37.048611111111114,0.0,99.0,439,7
Tennessee,1980,485,36.22268041237113,2.0,94.0,497,12
Tennessee,1981,417,35.44124700239808,0.0,90.0,426,9
Tennessee,1982,407,37.27272727272727,0.0,92.0,418,11
Tennessee,1983,383,36.331592689295036,0.0,98.0,393,10
Tennessee,1984,341,36.10263929618768,0.0,90.0,343,2
Tennessee,1985,380,35.636842105263156,0.0,82.0,387,7
Tennessee,1986,447,34.13646532438479,4.0,91.0,454,7
Tennessee,1987,398,34.379396984924625,0.0,90.0,404,6
Tennessee,1988,399,34.59649122807018,0.0,89.0,407,8
Tennessee,1989,368,34.45108695652174,0.0,88.0,371,3
Tennessee,1990,429,33.27505827505828,1.0,87.0,433,4
Tennessee,1991,397,33.46599496221663,0.0,84.0,401,4
Tennessee,1992,461,32.88503253796095,0.0,99.0,468,7
Tennessee,1993,460,32.893478260869564,0.0,92.0,468,8
Tennessee,1994,441,31.430839002267575,0.0,87.0,449,8
Tennessee,1995,467,32.54175588865096,0.0,90.0,473,6
Tennessee,1996,418,32.09569377990431,0.0,85.0,423,5
Tennessee,1997,429,33.05128205128205,0.0,85.0,439,10
Tennessee,1998,412,33.35436893203884,0.0,87.0,436,24
Tennessee,1999,391,33.214833759590796,0.0,87.0,411,20
Tennessee,2000,399,32.87468671679198,0.0,88.0,435,36
Tennessee,2001,402,35.20398009950249,0.0,90.0,444,42
Tennessee,2002,428,34.600467289719624,0.0,93.0,457,29
Tennessee,2003,416,35.07451923076923,0.0,99.0,426,10
Tennessee,2004,367,34.32970027247956,0.0,84.0,382,15
Tennessee,2005,447,33.758389261744966,0.0,94.0,463,16
Tennessee,2006,437,34.860411899313505,0.0,90.0,444,7
Tennessee,2007,437,33.496567505720826,0.0,86.0,445,8
Tennessee,2008,434,34.154377880184335,0.0,99.0,436,2
Tennessee,2009,478,34.04602510460251,0.0,83.0,486,8
Tennessee,2010,396,36.64646464646464,0.0,98.0,397,1
Tennessee,2011,419,35.15035799522673,0.0,91.0,421,2
Tennessee,2012,438,34.37442922374429,0.0,79.0,440,2
Tennessee,2013,363,33.69421487603306,0.0,80.0,363,0
Tennessee,2014,414,34.14251207729468,0.0,87.0,414,0
Tennessee,2015,450,34.06444444444445,0.0,86.0,451,1
Tennessee,2016,535,33.685981308411215,0.0,83.0,535,0
Tennessee,2017,593,33.20573355817875,0.0,88.0,596,3
Tennessee,2018,543,33.300184162062614,0.0,97.0,546,3
Tennessee,2019,565,33.60353982300885,0.0,88.0,566,1
Tennessee,2020,745,32.73422818791946,0.0,86.0,747,2
Tennessee,2021,757,33.19022457067371,0.0,84.0,760,3
Texas,1976,1462,33.913816689466486,0.0,99.0,1490,28
Texas,1977,1697,33.824985268120216,0.0,87.0,1742,45
Texas,1978,1842,33.56731813246471,0.0,87.0,1883,41
Texas,1979,2198,33.800272975432215,0.0,93.0,2290,92
Texas,1980,2314,32.80466724286949,0.0,98.0,2402,88
Texas,1981,2205,32.76326530612245,0.0,89.0,2293,88
Texas,1982,1787,33.95635142697258,0.0,95.0,1848,61
Texas,1983,2273,33.73075230972283,0.0,97.0,2352,79
Texas,1984,2103,33.392296718972894,0.0,94.0,2208,105
Texas,1985,2146,32.36160298229264,0.0,95.0,2248,102
Texas,1986,2235,33.03624161073825,0.0,96.0,2347,112
Texas,1987,1960,33.280102040816324,0.0,95.0,2039,79
Texas,1988,1934,33.664943123061015,0.0,99.0,2009,75
Texas,1989,2082,32.89865513928915,0.0,94.0,2142,60
Texas,1990,2408,32.43770764119601,0.0,90.0,2485,77
Texas,1991,2687,32.249348716040195,0.0,96.0,2768,81
Texas,1992,2287,31.685614341932663,0.0,94.0,2359,72
Texas,1993,2213,31.382738364211477,0.0,92.0,2271,58
Texas,1994,2066,31.600677637947726,0.0,90.0,2121,55
Texas,1995,1694,30.638724911452183,0.0,99.0,1733,39
Texas,1996,1516,32.29683377308707,0.0,91.0,1549,33
Texas,1997,1377,32.155410312273055,0.0,92.0,1428,51
Texas,1998,1416,31.73446327683616,0.0,92.0,1448,32
Texas,1999,1234,32.00729335494327,0.0,98.0,1268,34
Texas,2000,1273,32.29143754909662,0.0,95.0,1308,35
Texas,2001,1355,31.783025830258303,0.0,96.0,1387,32
Texas,2002,1348,32.56899109792285,0.0,95.0,1383,35
Texas,2003,1488,32.50067204301075,0.0,95.0,1510,22
Texas,2004,1405,33.27829181494662,0.0,89.0,1431,26
Texas,2005,1455,32.78625429553264,0.0,90.0,1480,25
Texas,2006,1436,32.41713091922006,0.0,99.0,1464,28
Texas,2007,1509,32.47316103379722,0.0,94.0,1533,24
Texas,2008,1457,32.89773507206589,0.0,96.0,1478,21
Texas,2009,1452,33.984848484848484,0.0,97.0,1470,18
Texas,2010,1357,33.49815770081061,0.0,92.0,1363,6
Texas,2011,1208,33.59685430463576,0.0,97.0,1217,9
Texas,2012,1252,34.0814696485623,0.0,89.0,1267,15
Texas,2013,1256,35.64570063694268,0.0,86.0,1272,16
Texas,2014,1314,33.93074581430746,0.0,93.0,1324,10
Texas,2015,1424,34.638342696629216,0.0,96.0,1436,12
Texas,2016,1581,34.09171410499684,0.0,99.0,1597,16
Texas,2017,1551,35.1605415860735,0.0,95.0,1581,30
Texas,2018,1437,34.72651356993737,0.0,96.0,1453,16
Texas,2019,1539,34.57115009746589,0.0,99.0,1549,10
Texas,2020,2125,33.400470588235294,0.0,93.0,2140,15
Texas,2021,2342,34.01280956447481,0.0,95.0,2365,23
Utah,1976,36,28.61111111111111,2.0,82.0,41,5
Utah,1977,36,37.111111111111114,0.0,85.0,36,0
Utah,1978,46,33.93478260869565,2.0,76.0,49,3
Utah,1979,53,31.867924528301888,0.0,96.0,54,1
Utah,1980,53,28.735849056603772,0.0,76.0,53,0
Utah,1981,54,26.85185185185185,0.0,66.0,54,0
Utah,1982,53,27.92452830188679,0.0,81.0,55,2
Utah,1983,55,23.072727272727274,0.0,79.0,56,1
Utah,1984,49,32.3469387755102,0.0,75.0,49,0
Utah,1985,49,32.57142857142857,0.0,83.0,53,4
Utah,1986,55,28.0,0.0,87.0,55,0
Utah,1987,56,31.25,0.0,69.0,56,0
Utah,1988,48,32.125,0.0,88.0,48,0
Utah,1989,46,34.32608695652174,1.0,87.0,46,0
Utah,1990,53,36.509433962264154,0.0,88.0,53,0
Utah,1991,53,25.943396226415093,0.0,79.0,55,2
Utah,1992,54,30.61111111111111,0.0,76.0,54,0
Utah,1993,68,30.705882352941178,0.0,92.0,69,1
Utah,1994,67,28.70149253731343,1.0,86.0,70,3
Utah,1995,76,31.276315789473685,1.0,78.0,78,2
Utah,1996,66,28.893939393939394,0.0,79.0,67,1
Utah,1997,75,27.733333333333334,0.0,83.0,75,0
Utah,1998,63,31.095238095238095,0.0,75.0,66,3
Utah,1999,58,30.810344827586206,1.0,78.0,58,0
Utah,2000,52,28.346153846153847,0.0,84.0,54,2
Utah,2001,79,32.70886075949367,0.0,81.0,82,3
Utah,2002,57,27.789473684210527,1.0,63.0,57,0
Utah,2003,60,32.11666666666667,0.0,77.0,61,1
Utah,2004,54,36.0,1.0,84.0,58,4
Utah,2005,57,30.42105263157895,0.0,83.0,60,3
Utah,2006,50,30.16,1.0,80.0,52,2
Utah,2007,64,32.25,0.0,76.0,65,1
Utah,2008,46,29.347826086956523,0.0,80.0,47,1
Utah,2009,40,36.975,0.0,71.0,41,1
Utah,2010,57,33.80701754385965,1.0,79.0,58,1
Utah,2011,55,35.981818181818184,0.0,83.0,55,0
Utah,2012,57,34.03508771929825,4.0,85.0,57,0
Utah,2013,51,35.64705882352941,0.0,85.0,51,0
Utah,2014,72,30.444444444444443,0.0,85.0,72,0
Utah,2015,60,30.633333333333333,0.0,82.0,61,1
Utah,2016,75,33.373333333333335,0.0,96.0,76,1
Utah,2017,81,32.30864197530864,0.0,85.0,82,1
Utah,2018,67,38.53731343283582,0.0,89.0,69,2
Utah,2019,79,32.18987341772152,0.0,80.0,79,0
Utah,2020,111,33.42342342342342,0.0,92.0,112,1
Utah,2021,97,35.50515463917526,0.0,99.0,98,1
Vermont,1976,11,34.18181818181818,14.0,74.0,12,1
Vermont,1977,2,46.5,39.0,54.0,3,1
Vermont,1978,12,39.583333333333336,1.0,83.0,12,0
Vermont,1979,5,43.2,22.0,63.0,5,0
Vermont,1980,9,41.22222222222222,12.0,84.0,9,0
Vermont,1981,9,32.0,0.0,63.0,9,0
Vermont,1982,5,46.0,23.0,77.0,5,0
Vermont,1983,6,28.166666666666668,20.0,41.0,6,0
Vermont,1984,14,41.714285714285715,16.0,67.0,14,0
Vermont,1985,15,38.13333333333333,5.0,72.0,17,2
Vermont,1986,12,27.833333333333332,0.0,67.0,12,0
Vermont,1987,16,34.125,0.0,87.0,16,0
Vermont,1988,11,26.363636363636363,2.0,54.0,12,1
Vermont,1989,11,40.81818181818182,21.0,76.0,11,0
Vermont,1990,14,34.785714285714285,23.0,77.0,14,0
Vermont,1991,14,31.642857142857142,14.0,48.0,14,0
Vermont,1992,11,36.0,15.0,93.0,11,0
Vermont,1993,13,31.307692307692307,2.0,52.0,13,0
Vermont,1994,6,41.0,21.0,58.0,6,0
Vermont,1995,13,45.53846153846154,27.0,68.0,13,0
Vermont,1996,16,36.75,0.0,73.0,16,0
Vermont,1997,9,38.22222222222222,4.0,82.0,9,0
Vermont,1998,12,46.416666666666664,16.0,80.0,12,0
Vermont,1999,20,33.5,0.0,76.0,20,0
Vermont,2000,10,35.0,15.0,46.0,10,0
Vermont,2001,7,34.285714285714285,18.0,55.0,7,0
Vermont,2002,13,27.53846153846154,9.0,56.0,13,0
Vermont,2003,15,39.0,17.0,85.0,15,0
Vermont,2004,16,40.1875,2.0,78.0,16,0
Vermont,2005,10,37.9,19.0,50.0,10,0
Vermont,2006,14,36.285714285714285,8.0,59.0,14,0
Vermont,2007,13,27.0,0.0,53.0,13,0
Vermont,2008,18,32.666666666666664,0.0,80.0,18,0
Vermont,2009,8,27.375,0.0,79.0,8,0
Vermont,2010,7,40.57142857142857,0.0,78.0,7,0
Vermont,2011,11,38.63636363636363,17.0,59.0,11,0
Vermont,2012,10,55.5,30.0,86.0,10,0
Vermont,2013,11,41.0,2.0,74.0,11,0
Vermont,2014,11,32.72727272727273,0.0,60.0,11,0
Vermont,2015,11,47.18181818181818,23.0,73.0,11,0
Vermont,2016,14,28.714285714285715,0.0,76.0,14,0
Vermont,2017,18,51.611111111111114,27.0,82.0,18,0
Vermont,2018,11,34.90909090909091,0.0,54.0,11,0
Vermont,2019,19,37.0,0.0,85.0,19,0
Vermont,2020,18,43.111111111111114,22.0,71.0,18,0
Vermont,2021,15,41.13333333333333,16.0,71.0,15,0
Virginia,1976,499,36.412825651302605,0.0,82.0,501,2
Virginia,1977,473,35.10570824524313,0.0,86.0,476,3
Virginia,1978,464,35.98275862068966,0.0,92.0,473,9
Virginia,1979,461,36.51409978308026,0.0,88.0,463,2
Virginia,1980,467,35.76017130620985,0.0,83.0,468,1
Virginia,1981,468,35.99145299145299,0.0,90.0,474,6
Virginia,1982,418,35.303827751196174,0.0,87.0,427,9
Virginia,1983,405,34.83456790123457,0.0,91.0,405,0
Virginia,1984,454,35.4647577092511,0.0,87.0,457,3
Virginia,1985,413,35.4818401937046,0.0,84.0,413,0
Virginia,1986,427,33.20843091334895,0.0,90.0,427,0
Virginia,1987,452,34.307522123893804,0.0,87.0,453,1
Virginia,1988,476,33.31512605042017,0.0,87.0,482,6
Virginia,1989,509,32.644400785854614,0.0,86.0,511,2
Virginia,1990,561,31.21212121212121,0.0,89.0,561,0
Virginia,1991,592,31.408783783783782,0.0,90.0,596,4
Virginia,1992,578,31.173010380622838,0.0,88.0,581,3
Virginia,1993,557,31.843806104129264,0.0,81.0,559,2
Virginia,1994,602,31.27906976744186,0.0,94.0,605,3
Virginia,1995,516,32.757751937984494,0.0,84.0,519,3
Virginia,1996,505,33.17821782178218,0.0,89.0,508,3
Virginia,1997,503,30.59045725646123,0.0,89.0,508,5
Virginia,1998,417,32.645083932853716,0.0,98.0,421,4
Virginia,1999,368,33.96467391304348,0.0,99.0,376,8
Virginia,2000,380,34.39473684210526,0.0,92.0,398,18
Virginia,2001,360,33.50277777777778,0.0,91.0,377,17
Virginia,2002,368,32.75271739130435,0.0,99.0,391,23
Virginia,2003,401,32.276807980049874,0.0,94.0,419,18
Virginia,2004,374,33.99732620320856,0.0,97.0,392,18
Virginia,2005,449,32.10022271714922,0.0,82.0,465,16
Virginia,2006,397,34.41057934508816,0.0,85.0,408,11
Virginia,2007,419,32.46778042959427,0.0,92.0,427,8
Virginia,2008,375,33.928,0.0,89.0,382,7
Virginia,2009,384,33.643229166666664,0.0,90.0,392,8
Virginia,2010,380,33.57631578947368,0.0,86.0,387,7
Virginia,2011,312,35.6025641025641,0.0,94.0,319,7
Virginia,2012,331,35.34743202416919,0.0,95.0,334,3
Virginia,2013,325,34.16923076923077,0.0,94.0,336,11
Virginia,2014,349,34.32091690544413,0.0,84.0,354,5
Virginia,2015,395,32.29113924050633,0.0,83.0,402,7
Virginia,2016,492,33.81707317073171,0.0,92.0,505,13
Virginia,2017,500,34.316,0.0,94.0,515,15
Virginia,2018,430,34.132558139534886,0.0,87.0,436,6
Virginia,2019,479,35.57202505219207,0.0,93.0,481,2
Virginia,2020,581,33.60413080895009,0.0,96.0,585,4
Virginia,2021,661,34.726172465960666,0.0,88.0,665,4
Washington,1976,161,34.21739130434783,0.0,90.0,162,1
Washington,1977,126,37.05555555555556,0.0,94.0,129,3
Washington,1978,164,35.02439024390244,0.0,94.0,164,0
Washington,1979,181,33.331491712707184,0.0,88.0,184,3
Washington,1980,219,35.054794520547944,0.0,91.0,222,3
Washington,1981,207,35.48309178743961,0.0,83.0,208,1
Washington,1982,190,32.43157894736842,0.0,89.0,192,2
Washington,1983,214,33.89719626168224,0.0,89.0,226,12
Washington,1984,205,31.458536585365852,0.0,87.0,216,11
Washington,1985,233,33.51502145922747,0.0,86.0,234,1
Washington,1986,220,31.37272727272727,0.0,87.0,225,5
Washington,1987,252,34.992063492063494,0.0,91.0,254,2
Washington,1988,265,33.64905660377359,0.0,89.0,273,8
Washington,1989,210,35.476190476190474,0.0,93.0,211,1
Washington,1990,245,33.93061224489796,0.0,84.0,249,4
Washington,1991,215,32.47441860465116,0.0,98.0,221,6
Washington,1992,273,30.802197802197803,0.0,92.0,274,1
Washington,1993,286,30.164335664335663,0.0,94.0,287,1
Washington,1994,316,31.037974683544302,0.0,90.0,317,1
Washington,1995,287,31.968641114982578,0.0,99.0,288,1
Washington,1996,257,32.284046692607006,0.0,86.0,258,1
Washington,1997,250,32.988,0.0,91.0,250,0
Washington,1998,212,31.778301886792452,0.0,84.0,215,3
Washington,1999,181,31.027624309392266,0.0,89.0,182,1
Washington,2000,202,33.60891089108911,0.0,95.0,203,1
Washington,2001,198,34.30808080808081,0.0,83.0,199,1
Washington,2002,207,35.01449275362319,0.0,89.0,208,1
Washington,2003,201,34.24875621890547,0.0,89.0,204,3
Washington,2004,204,32.76470588235294,0.0,88.0,208,4
Washington,2005,224,34.924107142857146,0.0,95.0,226,2
Washington,2006,206,33.189320388349515,0.0,90.0,207,1
Washington,2007,183,34.31693989071038,0.0,93.0,186,3
Washington,2008,209,33.27751196172249,0.0,92.0,210,1
Washington,2009,205,34.64878048780488,0.0,88.0,207,2
Washington,2010,175,34.097142857142856,0.0,89.0,175,0
Washington,2011,182,37.994505494505496,0.0,94.0,183,1
Washington,2012,215,35.544186046511626,0.0,87.0,215,0
Washington,2013,193,36.38341968911917,0.0,97.0,194,1
Washington,2014,204,34.15686274509804,0.0,99.0,206,2
Washington,2015,222,35.86486486486486,0.0,92.0,224,2
Washington,2016,213,37.032863849765256,0.0,95.0,213,0
Washington,2017,239,35.63179916317991,0.0,95.0,242,3
Washington,2018,253,36.58498023715415,0.0,89.0,255,2
Washington,2019,228,37.478070175438596,0.0,86.0,229,1
Washington,2020,333,35.55555555555556,0.0,97.0,337,4
Washington,2021,350,35.28857142857143,0.0,89.0,360,10
West Virginia,1976,108,37.94444444444444,1.0,95.0,108,0
West Virginia,1977,119,39.378151260504204,1.0,90.0,119,0
West Virginia,1978,130,38.34615384615385,2.0,88.0,130,0
West Virginia,1979,120,33.325,0.0,86.0,120,0
West Virginia,1980,132,38.29545454545455,1.0,87.0,134,2
West Virginia,1981,122,36.631147540983605,1.0,86.0,122,0
West Virginia,1982,107,36.373831775700936,1.0,82.0,107,0
West Virginia,1983,97,38.381443298969074,4.0,85.0,97,0
West Virginia,1984,88,34.55681818181818,1.0,74.0,88,0
West Virginia,1985,75,36.093333333333334,2.0,83.0,75,0
West Virginia,1986,120,36.325,1.0,94.0,120,0
West Virginia,1987,104,36.16346153846154,1.0,83.0,104,0
West Virginia,1988,100,35.53,2.0,83.0,101,1
West Virginia,1989,125,38.904,1.0,88.0,125,0
West Virginia,1990,110,36.5,1.0,84.0,110,0
West Virginia,1991,111,36.3963963963964,1.0,69.0,112,1
West Virginia,1992,117,34.92307692307692,1.0,70.0,118,1
West Virginia,1993,129,36.0,1.0,87.0,129,0
West Virginia,1994,110,40.3,1.0,88.0,110,0
West Virginia,1995,91,37.0989010989011,1.0,86.0,92,1
West Virginia,1996,67,33.19402985074627,1.0,86.0,69,2
West Virginia,1997,85,36.68235294117647,1.0,86.0,85,0
West Virginia,1998,80,38.775,12.0,89.0,81,1
West Virginia,1999,69,39.78260869565217,14.0,79.0,69,0
West Virginia,2000,61,31.327868852459016,0.0,72.0,64,3
West Virginia,2001,39,45.02564102564103,1.0,88.0,40,1
West Virginia,2002,73,37.47945205479452,0.0,83.0,76,3
West Virginia,2003,64,40.171875,0.0,93.0,65,1
West Virginia,2004,60,35.733333333333334,2.0,82.0,66,6
West Virginia,2005,77,31.545454545454547,0.0,76.0,78,1
West Virginia,2006,72,39.416666666666664,0.0,95.0,76,4
West Virginia,2007,62,31.322580645161292,0.0,75.0,62,0
West Virginia,2008,57,39.07017543859649,0.0,80.0,64,7
West Virginia,2009,76,40.55263157894737,1.0,84.0,77,1
West Virginia,2010,56,34.642857142857146,0.0,73.0,57,1
West Virginia,2011,79,36.037974683544306,0.0,81.0,84,5
West Virginia,2012,69,38.34782608695652,3.0,84.0,72,3
West Virginia,2013,56,40.607142857142854,1.0,88.0,58,2
West Virginia,2014,71,38.80281690140845,0.0,90.0,74,3
West Virginia,2015,70,37.32857142857143,1.0,89.0,72,2
West Virginia,2016,79,33.44303797468354,0.0,80.0,80,1
West Virginia,2017,104,43.24038461538461,0.0,92.0,109,5
West Virginia,2018,61,37.36065573770492,1.0,88.0,65,4
West Virginia,2019,83,35.12048192771084,1.0,74.0,84,1
West Virginia,2020,118,41.79661016949152,0.0,89.0,120,2
West Virginia,2021,103,37.62135922330097,0.0,80.0,107,4
Wisconsin,1976,151,34.72185430463576,0.0,85.0,151,0
Wisconsin,1977,139,34.26618705035971,0.0,88.0,139,0
Wisconsin,1978,122,32.4344262295082,0.0,77.0,122,0
Wisconsin,1979,171,33.58479532163743,0.0,91.0,174,3
Wisconsin,1980,145,30.317241379310346,0.0,82.0,145,0
Wisconsin,1981,148,37.03378378378378,0.0,96.0,148,0
Wisconsin,1982,148,35.358108108108105,0.0,85.0,148,0
Wisconsin,1983,134,33.723880597014926,0.0,85.0,135,1
Wisconsin,1984,124,34.854838709677416,0.0,91.0,124,0
Wisconsin,1985,142,33.514084507042256,0.0,84.0,142,0
Wisconsin,1986,144,29.243055555555557,0.0,89.0,144,0
Wisconsin,1987,168,32.98809523809524,0.0,86.0,168,0
Wisconsin,1988,143,32.72027972027972,0.0,83.0,145,2
Wisconsin,1989,176,29.931818181818183,0.0,84.0,176,0
Wisconsin,1990,237,30.11392405063291,0.0,92.0,238,1
Wisconsin,1991,247,29.93522267206478,0.0,92.0,248,1
Wisconsin,1992,218,30.46330275229358,0.0,90.0,219,1
Wisconsin,1993,240,29.195833333333333,0.0,76.0,241,1
Wisconsin,1994,246,28.398373983739837,0.0,90.0,247,1
Wisconsin,1995,241,29.033195020746888,0.0,87.0,241,0
Wisconsin,1996,225,29.622222222222224,0.0,93.0,225,0
Wisconsin,1997,223,31.183856502242154,0.0,91.0,225,2
Wisconsin,1999,198,27.95959595959596,0.0,85.0,200,2
Wisconsin,2000,172,28.930232558139537,0.0,88.0,172,0
Wisconsin,2001,198,28.59090909090909,0.0,81.0,198,0
Wisconsin,2002,161,32.18633540372671,0.0,77.0,166,5
Wisconsin,2003,191,28.026178010471206,0.0,84.0,193,2
Wisconsin,2004,158,31.234177215189874,1.0,67.0,160,2
Wisconsin,2005,219,31.328767123287673,0.0,88.0,220,1
Wisconsin,2006,172,31.412790697674417,0.0,75.0,174,2
Wisconsin,2007,197,28.609137055837564,0.0,90.0,198,1
Wisconsin,2008,155,30.92258064516129,0.0,71.0,160,5
Wisconsin,2009,149,33.577181208053695,0.0,93.0,154,5
Wisconsin,2010,169,33.201183431952664,1.0,87.0,170,1
Wisconsin,2011,143,31.524475524475523,0.0,91.0,147,4
Wisconsin,2012,180,32.28888888888889,0.0,84.0,181,1
Wisconsin,2013,182,33.86813186813187,0.0,95.0,182,0
Wisconsin,2014,170,32.00588235294118,0.0,79.0,171,1
Wisconsin,2015,254,32.118110236220474,0.0,92.0,255,1
Wisconsin,2016,266,33.63157894736842,0.0,78.0,267,1
Wisconsin,2017,256,33.20703125,0.0,96.0,257,1
Wisconsin,2018,220,32.20454545454545,0.0,97.0,224,4
Wisconsin,2019,253,35.44664031620553,0.0,88.0,256,3
Wisconsin,2020,421,34.60332541567696,0.0,92.0,423,2
Wisconsin,2021,398,32.404522613065325,0.0,97.0,399,1
Wyoming,1976,22,38.81818181818182,18.0,80.0,22,0
Wyoming,1977,16,31.8125,2.0,67.0,16,0
Wyoming,1978,23,37.17391304347826,20.0,73.0,24,1
Wyoming,1979,43,32.04651162790697,0.0,74.0,44,1
Wyoming,1980,31,29.677419354838708,4.0,73.0,34,3
Wyoming,1981,26,32.80769230769231,0.0,65.0,26,0
Wyoming,1982,34,40.3235294117647,18.0,82.0,34,0
Wyoming,1983,30,29.1,0.0,68.0,30,0
Wyoming,1984,20,37.7,0.0,86.0,20,0
Wyoming,1985,25,29.2,0.0,66.0,25,0
Wyoming,1986,29,29.517241379310345,1.0,65.0,29,0
Wyoming,1987,11,29.545454545454547,0.0,84.0,11,0
Wyoming,1988,14,35.0,1.0,60.0,14,0
Wyoming,1989,22,29.136363636363637,0.0,65.0,22,0
Wyoming,1990,23,28.956521739130434,5.0,76.0,23,0
Wyoming,1991,15,31.333333333333332,1.0,85.0,15,0
Wyoming,1992,20,31.75,0.0,55.0,20,0
Wyoming,1993,18,34.388888888888886,0.0,76.0,18,0
Wyoming,1994,20,36.2,17.0,73.0,20,0
Wyoming,1995,12,26.5,0.0,62.0,12,0
Wyoming,1996,18,33.0,15.0,55.0,18,0
Wyoming,1997,18,32.55555555555556,3.0,60.0,18,0
Wyoming,1998,17,28.058823529411764,0.0,62.0,17,0
Wyoming,1999,13,34.53846153846154,16.0,62.0,13,0
Wyoming,2000,12,33.416666666666664,0.0,78.0,12,0
Wyoming,2001,11,34.63636363636363,0.0,83.0,11,0
Wyoming,2002,16,46.75,16.0,77.0,16,0
Wyoming,2003,17,22.764705882352942,0.0,55.0,17,0
Wyoming,2004,13,21.846153846153847,0.0,59.0,13,0
Wyoming,2005,17,32.11764705882353,1.0,77.0,17,0
Wyoming,2006,9,29.22222222222222,19.0,48.0,9,0
Wyoming,2007,17,28.176470588235293,2.0,54.0,18,1
Wyoming,2008,11,32.36363636363637,0.0,60.0,11,0
Wyoming,2009,12,30.833333333333332,0.0,79.0,12,0
Wyoming,2010,8,29.75,0.0,42.0,8,0
Wyoming,2011,18,20.666666666666668,0.0,42.0,20,2
Wyoming,2012,17,32.94117647058823,0.0,74.0,17,0
Wyoming,2013,17,37.705882352941174,10.0,70.0,17,0
Wyoming,2014,14,34.42857142857143,0.0,76.0,14,0
Wyoming,2015,16,32.375,0.0,76.0,18,2
Wyoming,2016,21,34.19047619047619,0.0,79.0,23,2
Wyoming,2017,14,36.785714285714285,1.0,65.0,14,0
Wyoming,2018,17,35.88235294117647,2.0,75.0,17,0
Wyoming,2019,15,41.733333333333334,20.0,68.0,15,0
Wyoming,2020,20,38.25,13.0,60.0,20,0
Wyoming,2021,32,31.625,0.0,68.0,33,1
